ABALONE	an edible shellfish [n -S]
ABATERS	ABATER, one who abates (to reduce in intensity) [n]
ABATURE	trail of a stag through undergrowth [n -S]
ABDOMEN	the belly [n ABDOMENS or ABDOMINA]
ABELIAN	having the property a x b = b x a [adj]
ABELIAS	ABELIA, a plant with pink or white flowers [n]
ABETTER	one who abets, also ABETTOR [n -S]
ABETTOR	one who abets, also ABETTER [n -S]
ABIETIC	as in abietic acid, a soap ingredient [adj]
ABIOSES	ABIOSIS, absence of life [n]
ABITURS	ABITUR, in Germany, the final-year school examinations [n]
ABLUENT	a cleansing agent [n -S]
ABLUTED	washed clean [adj]
ABODING	ABODE, to forebode (to indicate in advance, also FORBODE) [v]
ABORTED	ABORT, to come to nothing [v]
ABORTEE	a woman who has had an abortion [n -S]
ABORTER	one who aborts (to come to nothing) [n -S]
ABREAST	side by side [adv]
ABREGES	ABREGE, an abridgement [n]
ABRIDGE	to shorten (to check or lessen the length) [v ABRIDGED, ABRIDGING, ABRIDGES] : ABRIDGER, ABRIDGMENT [n]
ABROSIA	a fasting (abstaining from eating) [n -S]
ABSTAIN	to refrain from [v -ED, -ING, -S]
ABUSION	misuse [n -S]
ACARINE	a tick-like animal, also ACARID, ACARIDAN [n -S]
ACAROID	resembling an acarid (a tick-like animal, also ACARIDAN, ACARINE) [adj]
ACATERS	ACATER, a caterer (one who caters (to provide food and service)) [n]
ACEDIAS	ACEDIA, apathy (indifference) [n]
ACERATE	needle-shaped [adj]
ACEROLA	a West Indian shrub [n -S]
ACEROUS	needle-shaped [adj]
ACETONE	a flammable liquid [n -S]
ACETOSE	like vinegar [adj]
ACETOUS	like vinegar [adj]
ACHENIA	ACHENIUM, a dry fruit which doesn't open when mature [n]
ACHIEST	ACHY, aching [adj]
ACHIOTE	a yellowish red dye, also ANATTA, ANATTO, ANNATTA, ANNATTO, ROUCOU [n -S]
ACIDIER	ACIDY, sour (sharp or biting to the taste) [adj]
ACINOUS	relating to a sacklike division of a gland, also ACINOSE, ACINAR, ACINIC [adj]
ACMITES	ACMITE, a pyramid shaped crystal [n]
ACNODES	ACNODE, an isolated point on a mathematical curve [n]
ACOLYTE	an assistant, also ACOLYTH [n -S]
ACORNED	having acorns (the fruit of the oak tree) [adj]
ACRASIN	a substance secreted by a slime mold [n -S]
ACRIDER	ACRID, pungent (sharply affecting the organs of taste or smell) [adj]
ACRIDIN	a chemical compound [n -S]
ACROGEN	a non-flowering plant [n -S]
ACROTER	a pedestal [n -S]
ACTINAL	pertaining to the area near the mouth of a starfish or a jellyfish; oral [adj]
ACTINON	an isotope of radon [n -S]
ACTIVES	ACTIVE, a participating member of an organization [n]
ACTURES	ACTURE, an action [n]
ADAPTER	one who modifies (to alter slightly) [n -S]
ADENOID	glandular tissue at the back of the nose [n -S]
ADENOMA	a tumor of glandular origin [n ADENOMAS or ADENOMATA]
ADENYLS	ADENYL, a univalent radical [n]
ADEPTER	ADEPT, highly skilled [adj]
ADHERES	ADHERE, to stick (to support with slender pieces of wood) [v]
ADIPOSE	animal fat [n -S]
ADIPOUS	pertaining to animal fat [adj]
ADJOINT	a related form of a mathematical matrix [n -S]
ADMIRER	one who admires (to have a high opinion of) [n -S]
ADONIZE	to adorn (oneself), also ADONISE [v ADONIZED, ADONIZING, ADONIZES]
ADOPTEE	one who is adopted [n -S]
ADOPTER	one who adopts (to take as one's own) [n -S]
ADORNED	ADORN, to embellish [v]
ADVENES	ADVENE, to be added over and above [v]
ADVERSE	acting against [adj ADVERSER, ADVERSEST]
ADVISEE	one who is given counsel [n -S]
ADVISOR	one who gives counsel [n -S]
ADWOMEN	ADWOMAN, a woman employed in the advertising business [n]
AECIDIA	AECIDIUM, a cup-shaped structure in rust fungi, also AECIUM [n]
AEROBAT	one that performs feats in an aircraft [n -S]
AEROBIA	AEROBIUM, an organism that requires free oxygen, also AEROBE [n]
AEROBIC	requiring free oxygen [adj]
AEROBOT	an unmanned gas-filled craft used to conduct experiments in planetary atmospheres [n -S]
AFEARED	AFEAR, to frighten, also AFFEAR, AFFEARE [v]
AGATIZE	to cause to resemble agate, also AGATISE [v AGATIZED, AGATIZING, AGATIZES]
AGENIZE	to treat with agene, also AGENISE [v AGENIZED, AGENIZING, AGENIZES]
AGNIZED	AGNIZE, to acknowledge, also AGNISE [v]
AGNOSIC	ss losing ability to recognize familiar objects [adj]
AGONIZE	to suffer agony, also AGONISE [v AGONIZED, AGONIZING, AGONIZES]
AGRIZED	AGRIZE, to terrify, also AGRISE, AGRYZE [v]
AGRIZES	AGRIZE, to terrify, also AGRISE, AGRYZE [v]
AIDANCE	help [n -S]
AIRBASE	a centre for controlling aircraft [n -S]
AIRBOAT	a boat used in swampy areas [n -S]
AIRFARE	payment for travel by air [n -S]
AIRFOIL	part of an aircraft providing lift or control [n -S]
AIRGLOW	a glow in the upper atmosphere [n -S]
AIRHEAD	an idiot (a mentally deficient person) [n -S]
AIRHOLE	a hole for the passage of air [n -S]
AIRLIFT	to transport by air [v -ED, -ING, -S]
AIRLIKE	resembling air [adj]
AIRPORT	a station for air transport of passengers and cargo [n -S]
AIRPOST	the system of conveying mail by air [n -S]
AIRSHOT	an aircheck (a recording made from a radio broadcast) [n -S]
AIRSTOP	a helicopter stopping place [n -S]
AIRTIME	an allowable period of time for a broadcast [n -S]
AIRWAVE	a channel for broadcasting [n -S]
AIRWISE	skillful in aviation [adj]
AITCHES	AITCH, the letter H [n]
AKENIAL	relating to an achene, also ACHENIAL [adj]
ALAMODE	a silk fabric [n -S]
ALBEDOS	ALBEDO, the measure of the reflecting power of an object [n]
ALBERGO	an inn, also AUBERGE [n ALBERGHI]
ALBINOS	ALBINO, a person or organism lacking normal pigmentation [n]
ALCAIDE	the commander of Spanish fortress, also ALCAYDE [n -S]
ALENCON	a needlepoint lace [n -S]
ALENGTH	at full length [adv]
ALEPINE	material of wool and silk [n -S]
ALETHIC	pertaining to truth or possibility [adj]
ALEWIFE	a woman who sells ale [n ALEWIVES]
ALEXINE	a substance in the blood which protects against disease, also ALEXIN [n -S]
ALEYING	ALEYE, to quell, also ALLAY, ALAY [v]
ALFREDO	cooked wiht a cheese and egg sauce [adj]
ALGESIC	capable of feeling pain, also ALGETIC [n pl.]
ALGETIC	capable of feeling pain, also ALGESIC [n pl.]
ALIBIED	ALIBI, to make excuses for oneself [v]
ALIBIES	ALIBI, to make excuses for oneself [v]
ALICANT	a wine from Spain [n -S]
ALLEGRO	a musical passage in rapid tempo [n -S]
ALLONGE	an addition to a document [n -S]
ALMONER	one who distributes alms, also ALMNER [n -S]
ALNICOS	ALNICO, a magnetic alloy [n]
ALODIUM	land held absolutely, also ALLODIUM, ALOD [n ALODIUMS or ALODIA]
ALOETIC	medicine containing aloes [n -S]
ALPEENS	ALPEEN, a cudgel [n]
ALTHORN	a tenor saxhorn [n -S]
ALUMINE	an oxide of aluminum, also ALUMIN, ALUMINA [n -S]
ALVEOLI	ALVEOLUS, a small body cavity, also ALVEOLE [n]
AMARONE	a dry red wine [n -S]
AMATEUR	one who engages in an activity for pleasure [n -S]
AMATION	love-making [n -S]
AMATIVE	amorous (pertaining to love) [adj]
AMBONES	AMBO, a pulpit in an early Christian church [n]
AMBRIES	AMBRY, a cupboard for sacred vessels, also ALMERY, ALMIRAH, AMBERY, AUMBRY, AWMRIE, AWMRY [n]
AMEARST	AMERCE, to fine or punish [v]
AMEBOID	resembling an ameba, also AMOEBOID [adj]
AMELIAS	AMELIA, being born without one or more limbs [n]
AMENDER	one who amends (to correct (to make right)) [n -S]
AMENDES	AMENDE, a fine [n]
AMENING	AMEN, to conclude prayerfully [v]
AMENTAL	of a catkin [adj]
AMIDASE	an enzyme (a complex protein, also ENZYM) [n -S]
AMIDINE	a type of chemical compound [n -S]
AMIDOLS	AMIDOL, a chemical compound [n]
AMIDONE	a chemical compound [n -S]
AMIRATE	the rank of an amir, also AMEERATE [n -S]
AMITIES	AMITY, friendship [n]
AMOEBAN	pertaining to a amoeba (a one-celled animal of ever-changing shape, also AMEBA) [adj]
AMORANT	pertaining to romantic love [adj]
AMORCES	AMORCE, a percussion cap for a toy pistol [n]
AMORINI	AMORINO, a lover (someone who loves) [n]
AMORINO	a lover (someone who loves) [n AMORINI]
AMORIST	a lover (someone who loves) [n -S]
AMOTION	the removal of a corporate officer from his office [n -S]
AMREETA	a beverage that bestows immortality in Hindu mythology, also AMRITA [n -S]
AMRITAS	AMRITA, a beverage that bestows immortality in Hindu mythology, also AMREETA [n]
AMULETS	AMULET, a lucky charm [n]
ANAEMIA	a disorder of the blood, also ANEMIA [n -S]
ANAEMIC	suffering from anaemia, also ANEMIC [adj] : ANAEMICALLY ~adv
ANALITY	a type of psychological state [n ANALITIES]
ANALYTE	a substance being analyzed [n -S]
ANAPEST	a type of metrical foot, also ANAPAEST [n -S]
ANCIENT	an aged man [n -S]
ANCOMES	ANCOME, sudden inflammation [n]
ANCONES	ANCON, the elbow [n]
ANDROID	a human robot [n -S]
ANDVILE	anvil [n -S]
ANELACE	a short dagger, also ANLACE [n -S]
ANEMONE	a flowering plant [n -S]
ANETHOL	a chemical compound, also ANETHOLE [n -S]
ANGELIC	pertaining to a divine messenger [adj]
ANGERLY	in an angry manner [adv]
ANGICOS	ANGICO, a South American tree [n]
ANGIOMA	a benign tumour [n -S]
ANGLICE	in English [adv]
ANICUTS	ANICUT, a dam, also ANNICUT [n]
ANILITY	dotage (the state of senility) [n ANILITIES]
ANIMATO	in a lively manner (music) [adv]
ANIMIST	an adherent of animism (the attribution of a soul to natural objects and phenomena) [n -S]
ANNOYED	ANNOY, to irritate (to provoke (to arouse to anger or sexual desire)) [v]
ANNOYER	one who annoys (to irritate (to provoke)) [n -S]
ANOBIID	a beetle with a hood, like the deathwatch beetle [n -S]
ANODIZE	to give a protective coat, also ANODISE [v ANODIZED, ANODIZING, ANODIZES]
ANODYNE	a medicine that relieves pain [n -S]
ANOLYTE	the part of an electricity conduction solution near the anode [n -S]
ANOPIAS	ANOPIA, a visual defect [n]
ANOPSIA	a visual defect [n -S]
ANOREXY	lack of appetite [n ANOREXIES]
ANOSMIA	the loss of sense of smell [n -S]
ANOTHER	one more [adj]
ANTACID	a substance which counteracts acidity [n -S]
ANTBEAR	the great anteater [n -S]
ANTBIRD	an ant thrush [n -S]
ANTEFIX	a roof ornament [n ANTEFIXES or ANTEFIXA]
ANTHOID	flower-like [adj]
ANTICAL	above or in front of another plant part, anterior [adj]
ANTICAR	opposed to cars [adj]
ANTICKE	antique, old [adj]
ANTIFLU	combating the flu [adj]
ANTIFOG	acting to stop a car window from fogging up [adj]
ANTIFUR	opposed to wearing animal fur [adj]
ANTIPOT	opposed to using marijuana [adj]
ANTIQUE	to give the appearance of age to [v ANTIQUED, ANTIQUING, ANTIQUES]
ANTIWAR	opposed to war [adj]
ANVILED	ANVIL, to shape on a heavy iron block [v]
ANXIETY	chronic apprehension [n ANXIETIES]
ANYMORE	any longer [adv]
ANYONES	ANYONE, anybody at all [n]
ANYWISE	in any degree [adv]
APATITE	a mineral [n -S]
APESHIT	(Vulg.) berserk; destructively crazy [adj]
APIEZON	as in apiezon oils, the residue of almost zero vapour pressure left by vacuum distillation of petroleum products [adj]
APNOEAL	pertaining to apnea (temporary cessation of breathing, also APNOEA) [adj]
APNOEAS	APNOEA, temporary cessation of breathing, also APNEA [n]
APNOEIC	pertaining to apnea (temporary cessation of breathing, also APNOEA) [adj]
APOGEAN	relating to an apogee [adj]
APOGEES	APOGEE, the farthest point from the earth of a heavenly body [n]
APOGEIC	relating to an apogee [adj]
APOLUNE	a point in the orbit of a body farthest from the moon [n -S]
APORIAS	APORIA, in rhetoric, a professed doubt [n]
APRICOT	an orange fruit, also APRICOCK [n -S]
APRONED	APRON, to provide with a protective garment [v]
APROTIC	acting as a certain solvent [adj]
APTERAL	wingless, also APTEROUS [adj]
APTERIA	APTERIUM, a bare patch on a bird's skin [n]
APTOTES	APTOTE, an indeclinable noun [n]
ARABINS	ARABIN, the essential chemical within gum arabic [n]
ARABISE	to adopt Arab customs, also ARABIZE [v ARABISED, ARABISING, ARABISES]
ARBITER	an umpire [n -S]
ARBORED	having trees [adj]
ARBORES	ARBOR, a shady garden shelter [n]
ARBORET	a shrubbery [n -S]
ARBUTES	ARBUTE, an evergreen tree, also ARBUTUS [n]
ARCHAEI	ARCHAEUS, an inner controlling spirit, also ARCHEUS [n]
ARCHINE	a Russian unit of length, also ARSHEEN, ARSHIN, ARSHINE [n -S]
ARCTIID	a moth (a winged insect) [n -S]
ARCTOID	bearlike (like a bear) [adj]
ARCUATE	arched like a bow, also ARCUATED [adj]
AREFIED	AREFY, to dry up [v]
ARGOTIC	pertaining to argot (a type of slang) [adv]
ARIDITY	the state of being arid (dry (having no moisture)) [n ARIDITIES]
ARMHOLE	a hole in a garment for the arm [n -S]
ARMIGER	one who carries the armor of a knight, also ARMIGERO [n -S]
ARMOIRE	a large ornate cabinet [n -S]
ARMORED	ARMOR, to dress with defensive covering, also ARMOUR [v]
ARNICAS	ARNICA, a perennial herb [n]
ARRIERO	a muleteer (a mule-driver) [n -S]
ARRIVED	ARRIVE, to reach a destination [v]
ARRIVES	ARRIVE, to reach a destination [v]
ARROWED	ARROW, to indicate the position with a straight pointed missile [v]
ASCRIBE	to attribute [v ASCRIBED, ASCRIBING, ASCRIBES]
ASEPTIC	an aseptic substance [n -S]
ASHIVER	in a shivering state [adj]
ASINICO	stupid fellow [n -S]
ASPERGE	to sprinkle (to scatter drops on) [v ASPERGED, ASPERGING, ASPERGES]
ASPIRIN	a pain relieving drug [n -S]
ATABRIN	an anti-malaria powder, also ATEBRIN [n -S]
ATAXIES	ATAXY, loss of muscular coordination, also ATAXIA [n]
ATEMOYA	a tropical fruit [n -S]
ATHANOR	an alchemist's furnace [n -S]
ATHEISE	to talk as an atheist, also ATHEIZE [v ATHEISED, ATHEISING, ATHEISES]
ATHEISM	a belief that there is no god [n -S]
ATHEIST	one who believes that there is no god [n -S]
ATHEOUS	godless (worshipping no god) [adj]
ATIMIES	ATIMY, loss of honour [n]
ATISHOO	sound of a sneeze [n -S]
ATOCIAS	ATOCIA, sterility in a female [n]
ATOMIZE	to reduce to a fine spray, also ATOMISE [v ATOMIZED, ATOMIZING, ATOMIZES]
ATRIUMS	ATRIUM, a central courtyard [n]
ATROPIA	a medicine derived from the deadly nightshade, also ATROPIN, ATROPINE [n -S]
ATROPIN	a medicine derived from the deadly nightshade, also ATROPIA, ATROPINE [n -S]
ATTONCE	at once [adv]
AUBERGE	an inn, also ALBERGO [n -S]
AUCTION	to sell publicly to the highest bidder [v -ED, -ING, -S]
AUDIBLE	able to be heard [adj] / a football tactic [n -S] / to call an audible [v AUDIBLED, AUDIBLING, AUDIBLES]
AUDITED	AUDIT, to examine accounts [v]
AUGMENT	to increase (to become larger, also ENCREASE) [v -ED, -ING, -S]
AUREITY	properties of gold [n AUREITIES]
AURICLE	the external ear or ear-shaped part, also AURICULA [n -S]
AUTEURS	AUTEUR, the creator of a film [n]
AUTOMEN	AUTOMAN, a maker of automobiles [n]
AUTOPEN	a device for imitating signatures [n -S]
AVAILED	AVAIL, to find benefit, also AVAILE [v]
AVAILES	AVAILE, to find benefit, also AVAIL [v]
AVARICE	greed (excessive desire for gain or wealth) [n -S]
AVENGED	AVENGE, to take retribution for, also VENGE [v]
AVENGER	one who avenges (to take retribution for, also VENGE) [n -S]
AVENGES	AVENGE, to take retribution for, also VENGE [v]
AVENUES	AVENUE, a wide street [n]
AVERTED	AVERT, to ward off [v]
AVERTER	one that averts (to ward off) [n -S]
AVIATED	AVIATE, to fly an aircraft [v]
AVIATES	AVIATE, to fly an aircraft [v]
AVIATOR	a pilot who flies aircraft [n -S]
AVIETTE	a glider (a type of aircraft (a machine for travelling in the air)) [n -S]
AVOCETS	AVOCET, a wading bird, also AVOSET [n]
AVODIRE	an African tree [n -S]
AVOIDED	AVOID, to evade (to escape or avoid by cunning) [v]
AVOIDER	one who avoids (to evade (to escape or avoid by cunning)) [n -S]
AVOURES	AVOURE, an avowal (a declaration) [n]
AVOWERS	AVOWER, one who avows (to declare (to make known clearly)) [n]
AVOYERS	AVOYER, a chief magistrate [n]
AWAITED	AWAIT, to wait for [v]
AWAITER	one who awaits (to wait for) [n -S]
AWARDEE	one who is awarded something [n -S]
AWAREST	AWARE, knowing and alert [adj]
AWARNED	AWARN, to warn (to notify in advance) [v]
AWHETOS	AWHETO, the so-called vegetable caterpillar of New Zealand [n]
AWMRIES	AWMRIE, a cupboard for sacred vessels, also AMBRY, ALMERY, ALMIRAH, AMBERY, AUMBRY, AWMRY [n]
AXINITE	a brown mineral [n -S]
AZURINE	a bluish black dye [n -S]
AZURITE	a mineral [n -S]
BACONER	a pig suitable for bacon [n -S]
BADIOUS	chestnut-coloured [adj]
BAGNIOS	BAGNIO, a brothel (a house of prostitution) [n]
BAILEES	BAILEE, a person to whom property is bailed [n]
BAILIES	BAILIE, a Scottish magistrate [n]
BAILORS	BAILOR, a person who bails property to another, also BAILER [n]
BAILOUT	the act of parachuting from an aircraft [n -S]
BAINITE	a byproduct of steel treatment [n -S]
BALDEST	BALD, without hair [adj]
BALEENS	BALEEN, whalebone [n]
BALMIER	BALMY, fragrant (having a pleasant perfume) [adj]
BALONEY	nonsense (anything which makes no sense) [n -S]
BANALER	BANAL, flat and uninteresting [adj]
BANDARI	(Hindi) a female monkey, or a cheeky girl [n -S]
BANDITO	a bandit (an outlaw) [n -S]
BANDITS	BANDIT, an outlaw [n]
BANDORE	ancient musical instrument, also BANDORA, PANDORA, PANDORE, PANDURA [n -S]
BANGERS	BANGER, a sausage (finely chopped and seasoned meat in a casing) [n]
BANSHIE	a female spirit, also BANSHEE [n -S]
BAPTISE	to administer baptism, also BAPTIZE [v BAPTISED, BAPTISING, BAPTISES]
BARCODE	an arrangement, readable by computer, of thick and thin parallel lines, eg printed on, and giving coded details of, goods at a point of sale, library books, etc [n -S]
BARDIER	BARDY, insolent [adj]
BAREFIT	barefoot (being without shoes) [adj]
BAREGES	BAREGE, a silky dress fabric [n]
BARGEES	BARGEE, a bargeman (the manager opf a barge) [n]
BARISTA	one who makes and serves coffee to the public [n -S]
BARNIER	BARNY, like a barn [adj]
BARONET	the lowest British hereditary title [n -S]
BARONNE	a baroness (the wife of a baron) [n -S]
BARRIES	BARRY, (Australian slang) an embarrassing mistake, pl BARRIES, rhyming slang, a Barry Crocker, a shocker [n]
BARTEND	to serve in a bar [v -ED, -ING, -S]
BARTSIA	a family of parasitic weeds [n -S]
BATISTE	a fine linen [n -S]
BATONED	BATON, to strike with a truncheon, also BATOON [v]
BATTERO	a cudgel [n -S]
BATTIES	BATTY, a West Indian slang word for (a person's) bottom [n]
BAWDIER	BAWDY, obscene (indecent (offensive, obscene)) [adj]
BAWTIES	BAWTIE, a dog [n]
BAYONET	to stab with a dagger-like weapon [v BAYONETED or BAYONETTED, BAYONETING or BAYONETTING, BAYONETS]
BEACONS	BEACON, to shine like a light on high [v]
BEADERS	BEADER, one that beads (to adorn with round balls of glass, wood or plastic) [n]
BEADIER	BEADY, resembling beads [adj]
BEADING	work in beads [n -S]
BEAGLER	one who hunts with beagles [n -S]
BEAMIER	BEAMY, radiant [adj]
BEANERY	a cheap restaurant [n BEANERIES]
BEANIES	BEANIE, a small cap, also BEANY [n]
BEANING	BEAN, to hit on the head [v]
BEARDIE	a bearded person, also BEARDY [n -S]
BEARISH	in the manner of a bear [adj]
BEASTIE	a four-footed animal [n -S]
BEATING	a defeat [n -S]
BEATNIK	a bohemian or non-conformist [n -S]
BEAUFIN	a red cooking apple [n -S]
BEDAWIN	a nomadic Arab, also BEDOUIN, BEDU, BEDUIN [n -S]
BEDERAL	a church officer, also BEDRAL [n -S]
BEDOUIN	a nomadic Arab, also BEDAWIN, BEDU, BEDUIN [n -S]
BEDRALS	BEDRAL, a church officer, also BEDERAL [n]
BEDRITE	the privilege or due of the marriage-bed, also BEDRIGHT [n -S]
BEDSORE	an ulcer due to bed-confinement [n -S]
BEDUINS	BEDUIN, a nomadic Arab, also BEDOUIN, BEDAWIN, BEDU [n]
BEENTOS	BEENTO, (W Africa) someone who was educated in England [n]
BEETING	BEET, to improve (to make better) [v]
BEGONIA	a tropical plant [n -S]
BEGROAN	to moan (to utter a low, mournful sound) [v -ED, -ING, -S]
BEGUINE	a woman living as a nun without vows [n -S]
BEIGNES	BEIGNE, a fritter, also BEIGNET [n]
BEIGNET	a fritter, also BEIGNE [n -S]
BELATED	BELATE, to make late (coming after the expected time) [v]
BELATES	BELATE, to make late (coming after the expected time) [v]
BELIERS	BELIER, one who belies (to misrepresent) [n]
BELTING	a beating (a defeat) [n -S]
BEMEANT	BEMEAN, to debase (to lower or degrade) [v]
BEMOANS	BEMOAN, to lament (to cry out in grief) [v]
BENDIER	BENDY, full of bends [adj]
BENEATH	under (in a lower position than) [prep]
BENEFIT	to obtain an advantage [v BENEFITED or BENEFITTED, BENEFITING or BENEFITTING, BENEFITS]
BENISON	a blessing (a wish for success) [n -S]
BEPAINT	to colour (to paint, also COLOR) [v -ED, -ING, -S]
BERATED	BERATE, to scold severely [v]
BERETTA	a cap for a clergyman [n -S]
BERLINE	an old four-wheeled carriage, also BERLIN [n -S]
BESTING	BEST, to outdo (to exceed in performance) [v]
BETHORN	to fill with thorns [v -ED, -ING, -S]
BETIDES	BETIDE, to befall (to happen or occur to) [v]
BETREAD	to walk upon [v BETROD, BETRODDEN, BETREADING, BETREADS]
BIALIES	BIALY, an onion roll, also BIALI [n]
BICORNE	a hat with two corners, also BICORN [n -S]
BIENNIA	BIENNIUM, a period of two years [n]
BIGENER	a hybrid between genera [n -S]
BIGOTED	intolerant [adj]
BILAYER	a film with two molecular layers [n -S]
BILSTED	a hardwood tree [n -S]
BIMETAL	something composed of two metals [n -S]
BINDLES	BINDLE, a bundle [n]
BINOCLE	a binocular [n -S]
BIODATA	p biographical information [n pl.]
BIOTITE	a black mica [n -S]
BIOTRON	a climate control chamber [n -S]
BIPLANE	a plane with two sets of wings [n -S]
BIRSLED	BIRSLE, to scorch (to burn slightly) [v]
BISTATE	pertaining to two states [adj]
BITONAL	using two musical keys together [adj]
BITSIER	BITSY, small and attractive [adj]
BITTERN	a wading bird, also BITTOR, BITTOUR, BITTUR [n -S]
BLADERS	BLADER, one that blades [n]
BLANDER	BLAND, flat and uninteresting [adj]
BLARTED	BLART, to shout loudly and harshly [v]
BLASTED	BLAST, to use explosives [v]
BLEARED	BLEAR, to dim (to reduce the light of) [v]
BLEATED	BLEAT, to cry like a sheep [v]
BLEATER	a complainer [n -S]
BLINDER	a thing that blinds [n -S]
BLINGER	BLING, flashy (gaudy (tastelessly showy)) [adj]
BLOATED	BLOAT, to swell (to increase in size or volume) [v]
BLOATER	a smoked herring [n -S]
BLONDER	BLOND, light coloured, also BLONDE [adj]
BLOWIER	BLOWY, windy (marked by strong wind) [adj]
BLUDIER	BLUDY, stained with blood, also BLOODY, BLUDIE, BLUIDY [adj]
BLUIEST	BLUEY, somewhat blue [adj]
BLUNTER	BLUNT, not sharp [adj]
BOARDER	one who boards (to supply food and lodging for a fee) [n -S]
BOATING	the sport of travelling by boat [n -S]
BOATMEN	BOATMAN, a man who works on a boat, also BOATSMAN [n]
BODEGAS	BODEGA, a grocery store [n]
BODGIER	BODGIE, useless or fraudulent [adj]
BODGIES	BODGIE, a male cult figure of the 1950s [n]
BOILERY	a place for boiling [n BOILERIES]
BOINGED	BOING, to reverberate by bouncing, also BOINK [v]
BOLETES	BOLETE, a fungus (any of the major group of lower plants) [n]
BONDAGE	slavery (the ownership of one person by another) [n -S]
BONESET	a perennial herb [n -S]
BONFIRE	a large fire in the open air [n -S]
BONIATO	a sweet potato [n -S]
BONNIER	BONNY, pretty or healthy, also BONIE [adj]
BONNIES	BONNY, a sweetheart [n]
BOODIES	BOODIE, a type of rat-kangaroo [n]
BOONERS	BOONER, a young working class person from Canberra [n]
BOONIES	a backwoods area [n pl. pl]
BOOSTER	that which boosts [n -S]
BOOTIES	BOOTIE, a baby's sock, also BOOTEE [n]
BORACES	BORAX, a mineral [n]
BORAGES	BORAGE, an aromatic herb [n]
BORATED	BORATE, to mix with borax or boric acid [v]
BOREENS	BOREEN, a lane (a narrow passageway, also LANEWAY) [n]
BORNEOL	an alcohol used in perfumes, also BORNYL [n -S]
BORONIA	an Australian shrub [n -S]
BORTIER	BORTY, relating to bort [adj]
BOTANIC	relating to botany [adj] / a drug made from plants [n -S]
BOTHIES	BOTHY, a humble cottage [n]
BOTHRIA	BOTHRIUM, a groove on a tapeworm [n]
BOTONEE	having arms ending in a trefoil, also BOTONNEE [adj]
BOTTIES	BOTTY, a bottom [n]
BOTTINE	a high boot [n -S]
BOUGIES	BOUGIE, a wax candle [n]
BOULTER	a sieve [n -S]
BOUNDER	one that bounds (to leap (to spring off the ground)) [n -S]
BOURNES	BOURNE, a stream [n]
BOUSIER	BOUSY, inclined to booze, also BOOZY, BOOZEY [adj]
BOUTADE	a sudden outburst [n -S]
BOUVIER	a large dog [n -S]
BOVATES	BOVATE, as much land as one ox could plough [n]
BOVINES	BOVINE, an animal of the cattle family [n]
BOWLINE	a type of knot [n -S]
BOYSIER	BOYSY, suited to or typical of boys or young man [adj]
BRAAIED	BRAAI, (South Africa) to grill or roast meat over open coals [v]
BRAIDER	one who braids (to plait (to braid)) [n -S]
BRANGLE	to wrangle (to argue noisily) [v BRANGLED, BRANGLING, BRANGLES]
BRANTLE	an old French dance, also BRANSLE, BRANLE [n -S]
BRASERO	a brazier (a container for hot coals) [n -S]
BRASIER	one who works in brass [n -S]
BRAVOED	BRAVO, to applaud by shouting "bravo" [v]
BRAVOES	BRAVO, a hired killer [n]
BRAWLIE	splendidly [adv BRAWLIER, BRAWLIEST]
BREATHE	to inhale and exhale air [v BREATHED, BREATHING, BREATHES]
BREDING	BREDE, to braid, to plait [v]
BREIING	BREI, (South Africa) to pronounce r sound at the back of the throat, pa t BREID, pr t BREIING also BREY [v]
BREINGE	(Scots) to plunge forward, also BREENGE [v BREINGED, BREINGING, BREINGES]
BRIARED	covered with [adj BRIARS]
BRICOLE	a cushion shot in billiards [n -S]
BRIDLES	BRIDLE, to check or restrain [v]
BRIGADE	to group together [v BRIGADED, BRIGADING, BRIGADES]
BRINDLE	the state of being marked with spots and streaks [n -S]
BRINIES	BRINY, the sea (the ocean (vast sections of salt water over most of the world)) [n]
BROADEN	to make wider (extending far) [v -ED, -ING, -S]
BROADER	BROAD, wide (extending far) [adj]
BROCADE	to weave a silky fabric with a raised design [v BROCADED, BROCADING, BROCADES]
BROIDER	to adorn with needlework [v -ED, -ING, -S]
BROILED	BROIL, to cook over hot coals [v]
BROILER	a very hot day [n -S]
BROMATE	to combine with bromine [v BROMATED, BROMATING, BROMATES]
BROMIDE	a bromine compound, also BROMID [n -S]
BROMINE	a volatile liquid element, also BROMIN [n -S]
BROMISE	to treat with bromine, also BROMIZE [v BROMISED, BROMISING, BROMISES]
BROSIER	BROSY, smeared with brose [adj]
BROWNIE	a goblin (an evil or mischievous creature) [n -S]
BRUISED	BRUISE, to injure and discolour the skin [v]
BRUITED	BRUIT, to spread by rumour [v]
BRUNTED	BRUNT, to bear the chief stress of [v]
BUILDER	one who builds (to construct) [n -S]
BUISTED	BUIST, to brand livestock [v]
BUNDIES	BUNDY, to clock on or clock off work [v]
BURDIES	BURDIE, a maiden (a young unmarried woman) [n]
BURGEON	to grow rapidly [v -ED, -ING, -S]
BURNIES	BURNIE, a brooklet (a small brook) [n]
BURSATE	pertaining to a bursa (a bodily pouch) [adj]
BUSTIER	a woman's undergarment [n -S]
BUTANES	BUTANE, a flammable gas [n]
CABINED	CABIN, to live in a roughly built house [v]
CABINET	a piece of furniture with shelves and drawers [n -S]
CABRIES	CABRIE, a pronghorn, also CABRIT [n]
CADGIER	CADGY, cheerful, also KIDGIE [adj]
CAERULE	sky-blue, also CERULE [adj]
CAGANER	a traditional character in Catalan Christmas scenes, a squatting defecating person. [n -S]
CAGIEST	CAGY, shrewd, also CAGEY [adj]
CAGOULE	a light anorak, also CAGOUL, KAGOOL, KAGOUL, KAGOULE [n -S]
CAHIERS	CAHIER, a notebook (a book in which to write) [n]
CAITIVE	a captive [n -S]
CALENDS	the first day of the Roman month [n CALENDS]
CALIBER	the diameter of a gun barrel, also CALIBRE [n -S]
CALIBRE	the diameter of a gun barrel, also CALIBER [n -S]
CALIPEE	the edible part of a turtle, also CALIPASH, CALLIPEE [n -S]
CALIPER	to use a type of measuring device [v -ED, -ING, -S]
CALIVER	a type of light musket [n -S]
CALMIER	CALMY, clayey (resembling clay) [adj]
CALORIE	a unit of heat, also CALORY [n -S]
CALOTTE	a skullcap (a close-fitting cap) [n -S]
CALOYER	a monk of the Eastern church [n -S]
CAMELOT	a hawker (a peddler (one who peddles, also PEDLAR, PEDLER)) [n -S]
CAMOGIE	a type of game [n -S]
CAMOTES	CAMOTE, a type of sweet potato [n]
CANDIRU	a tiny S. American fish which can swim into a body orifice,where it attaches itself by means of a spine and feeds on blood and body tissue [n -S]
CANDLER	one that candles (to examine eggs in front of a light) [n -S]
CANDLES	CANDLE, to examine eggs in front of a light [v]
CANINES	CANINE, a dog [n]
CANNIER	CANNIE, prudent, also CANNY [adj]
CANTEEN	a container used for carrying water [n -S]
CANTION	a song (a musical composition written for singing) [n -S]
CANTLED	CANTLE, to divide (to separate into different parts) [v]
CANTRED	in early England, a division of a county, also CANTREF [n -S]
CANTREF	in early England, a division of a county, also CANTRED [n -S]
CAPELIN	a small edible fish, also CAPELAN, CAPLIN [n -S]
CAPOTES	CAPOTE, a hooded cloak or overcoat [n]
CAPRINE	pertaining to a goat, also CAPRIC [adj]
CAPTION	to provide with a title [v -ED, -ING, -S]
CARATES	CARATE, a tropical skin disease [n]
CARBEEN	the Moreton Bay ash [n -S]
CARBENE	a neutral divalent free radical [n -S]
CARBIDE	a carbon compound [n -S]
CARBIES	CARBY, the carburettor [n]
CARBINE	a light rifle [n -S]
CARDIAE	CARDIA, an opening of the esophagus [n]
CARDIOS	CARDIO, a cardiograph [n]
CARGOED	CARGO, to load (to place goods or cargo on transportation) [v]
CARGOES	CARGO, to load (to place goods or cargo on transportation) [v]
CARIBES	CARIBE, a voracious fish, the piranha [n]
CARIERE	career [n -S]
CARINAE	CARINA, a keel-like ridge [n]
CARINAL	relating to a carina [adj]
CARINAS	CARINA, a keel-like ridge [n]
CARIOLE	a small open carriage, also CARRIOLE [n -S]
CARIOUS	of teeth, affected with caries, decayed, also CARIOSE [adj]
CARITAS	love for all people [n -ES]
CARLINS	CARLIN, an old woman [n]
CARMINE	a vivid red colour [n -S]
CARNAGE	great and bloody slaughter [n -S]
CARNIER	CARNY, cunning (crafty (skillful in deceiving)) [adj]
CAROLED	CAROL, to sing joyously [v]
CAROLER	one who sings joyously, also CAROLLER [n -S]
CAROMED	CAROM, to collide with and rebound, also CARROM [v]
CAROMEL	caramel (a chewy candy) [n -S]
CAROTID	an artery in the neck [n -S]
CAROTIN	a plant pigment, also CAROTENE, CARROTIN [n -S]
CAROUSE	to engage in a carousal [v CAROUSED, CAROUSING, CAROUSES]
CARRIED	CARRY, to convey from one place to another [v]
CARRIES	CARRY, to convey from one place to another [v]
CARRION	dead and rotting flesh [n -S]
CARTAGE	the act of carting (to convey in a two wheeled vehicle) [n -S]
CARTING	CART, to convey in a two wheeled vehicle [v]
CARTOON	to sketch a humorous representation of [v -ED, -ING, -S]
CARVIES	CARVY, a herb used in cooking, also CARAWAY, CARRAWAY [n]
CASEATE	to become cheesy (resembling a food made from milk curds) [v CASEATED, CASEATING, CASEATES]
CASHIER	to dismiss in disgrace [v -ED, -ING, -S]
CASTLED	CASTLE, to make a certain move in chess [v]
CATELOG	to put in a catalogue [v -S]
CATENAE	CATENA, a closely linked series [n]
CATENAS	CATENA, a closely linked series [n]
CATERAN	a brigand (a bandit (an outlaw)) [n -S]
CATERED	CATER, to provide food and service [v]
CATERER	one who caters (to provide food and service) [n -S]
CATHODE	a negatively charged electrode, also KATHODE [n -S]
CATHOLE	a part of a ship [n -S]
CATLINS	CATLIN, a surgical knife, also CATLING [n]
CATTIES	CATTIE, an Asian unit of weight [n]
CAULDER	CAULD, cold (having no warmth) [adj]
CAULINE	pertaining to a stem [adj]
CAUTELS	CAUTEL, wariness (the state of being wary (watchful (closely alert))) [n]
CAUTERS	CAUTER, the burning with caustics [n]
CAUTION	to warn (to notify in advance) [v -ED, -ING, -S]
CAVIARE	the roe of sturgeon, also CAVIAR, CAVIARIE, CAVIER [n -S]
CAVIERS	CAVIER, the roe of sturgeon, also CAVIAR, CAVIARE, CAVIARIE [n]
CAVILER	one that cavils, also CAVILLER [n -S]
CEDRATE	citron (a lemonlike fruit) [n -S]
CEDRINE	belonging to the cedar-tree [adj]
CEILERS	CEILER, one that ceils (to furnish with a ceiling) [n]
CELADON	a pale green colour [n -S]
CELESTA	a keyboard instrument, also CELESTE [n -S]
CEMENTA	CEMENTUM, the hard tissue covering the roots of the teeth [n]
CENOTES	CENOTE, a sinkhole limestone [n]
CENSUAL	pertaining to a census [adj]
CENTAGE	rate by the hundred [n -S]
CENTAUR	a mythological creature [n -S]
CENTAVO	a coin of various nations [n -S]
CENTILE	a value of a statistical variable [n -S]
CENTIME	the 100th part of a franc [n -S]
CENTIMO	any of various small coins [n -S]
CENTRAL	a telephone exchange [n -S] / in the middle [adj CENTRALER, CENTRALEST]
CENTRED	CENTRE, to center (to place at the middle point) [v]
CERATED	covered with wax [adj]
CEREOUS	waxy (resembling wax) [adj]
CEROONS	CEROON, a hamper [n]
CERRADO	an area of wooded savanna in S America [n -S]
CERRIAL	of the turkey-oak [adj]
CERVINE	pertaining to deer (a ruminant mammal) [adj]
CESTODE	a tapeworm, also CESTOID [n -S]
CESURAE	CESURA, a pause in a line of verse, also CAESURA [n]
CESURAL	of a breathing space in a line of verse [adj]
CHAINED	CHAIN, to bind with linked rings [v]
CHAINES	CHAINE, a series of ballet turns [n]
CHAIRED	CHAIR, to install in office [v]
CHALONE	a hormone (a secretion of the endocrine organs) [n -S]
CHANTER	one who chants, also CHANTOR [n -S]
CHANTIE	a type of song (a musical composition written for singing) [n -S]
CHARIOT	to ride in a two-wheeled, horse-drawn vehicle [v -ED, -ING, -S]
CHARLIE	a fool, also CHARLEY [n -S]
CHEATER	one who cheats (to defraud (to swindle)) [n -S]
CHEERIO	goodbye, also CHEERO [n -S]
CHOANAE	CHOANA, a funnel-shaped opening [n]
CHOIRED	CHOIR, to sing in chorus [v]
CHOLATE	a chemical salt [n -S]
CHOLERA	an acute infection [n -S]
CHOLINE	an alcohol found bile [n -S]
CHORALE	a hymn that is sung in unison, also CHORAL [n -S]
CHORDAE	CHORDA, a primitive sort of spinal column [n]
CHOREAL	relating to chorea [adj]
CHOREAS	CHOREA, a nervous disorder [n]
CHORINE	a chorus girl [n -S]
CHORTEN	a Tibetan shrine [n -S]
CIERGES	CIERGE, a type of candle, also CERGE [n]
CIGARET	a narrow roll of finely cut tobacco for smoking [n -S]
CILIATE	a class of protozoans [n -S]
CINEOLE	a liquid used as an antiseptic, also CINEOL [n -S]
CINEREA	the grey matter of the brain [n -S]
CIRRATE	like a cirrus, also CIRROSE [adj]
CIRROSE	like a cirrus, also CIRRATE [adj]
CITABLE	suitable for citation, also CITEABLE [adj]
CITADEL	a fortress [n -S]
CITATOR	one who cites (to quote as an example) [n -S]
CITHERN	a pear-shaped guitar, also CITHER, CITHREN, CITOLA, CITOLE, CITTERN [n -S]
CITHREN	a pear-shaped guitar, also CITHER, CITHERN, CITOLA, CITOLE, CITTERN [n -S]
CITRALS	CITRAL, a lemon flavouring [n]
CITTERN	a pear-shaped guitar, also CITHER, CITHERN, CITHREN, CITOLA, CITOLE [n -S]
CLAIMER	one who makes a claim, also CLAIMANT [n -S]
CLANGER	a blunder [n -S]
CLARAIN	lustrous bands in coal [n -S]
CLARINI	CLARINO, the highest register of a trumpet in baroque music [n]
CLARINO	the highest register of a trumpet in baroque music [n CLARINOS or CLARINI]
CLARION	to sound a shrill clear trumpet [v -ED, -ING, -S]
CLARTED	CLART, to dirty (to soil (to make dirty)) [v]
CLAUTED	CLAUT, to scratch (to make a thin, shallow cut on) [v]
CLAVIER	an early keyboard instrument, also KLAVIER [n -S]
CLAYIER	CLAYEY, resembling clay [adj]
CLEANED	CLEAN, to rid of stain [v]
CLEANER	one that cleans (to rid of stain) [n -S]
CLEANSE	to clean (to rid of stain) [v CLEANSED, CLEANSING, CLEANSES]
CLEARED	CLEAR, to remove obstruction [v]
CLEATED	CLEAT, to strengthen with a piece of wood [v]
CLERIDS	CLERID, a beetle [n]
CLIMATE	to remain in a certain place [v CLIMATED, CLIMATING, CLIMATES]
CLINGER	one that clings (to adhere to) [n -S]
CLONERS	CLONER, one that clones (to reproduce by asexual means) [n]
CLOOTIE	as in clootie dumpling, a suet pudding, containing currants, raisins, etc, steamed or boiled in a cloth [adj]
CLOTURE	to end a debate by calling for a vote, also CLOSURE [v CLOTURED, CLOTURING, CLOTURES]
CLOUTER	one that clouts (to hit with the hand) [n -S]
CNEMIAL	relating to the shin [adj]
COAGENT	someone working together with another [n -S]
COAITAS	COAITA, a type of spider monkey [n]
COALIER	COALY, containing coal [adj]
COALING	COAL, to supply with a carbon fuel [v]
COALIZE	to bring into coalition, also COALISE [v COALIZED, COALIZING, COALIZES]
COALMEN	COALMAN, a coal merchant [n]
COAPTED	COAPT, to adjust (to regulate (to control according to rule)) [v]
COARSER	COARSE, rough (uneven (not even)) [adj]
COATEES	COATEE, a small coat [n]
COATING	a covering layer [n -S]
CODEIAS	CODEIA, a narcotic alkaloid, also CODEIN, CODEINA, CODEINE [n]
CODEINA	a narcotic alkaloid, also CODEIA, CODEIN, CODEINE [n -S]
CODEINE	a narcotic alkaloid, also CODEIA, CODEIN, CODEINA [n -S]
CODEINS	CODEIN, a narcotic alkaloid, also CODEIA, CODEINA, CODEINE [n]
CODETTA	a short coda [n -S]
CODRIVE	to work as a co-driver [v CODROVE, CODRIVEN, CODRIVING, CODRIVES]
COENURE	a tapeworm larva, also COENURUS [n -S]
COENURI	COENURUS, a tapeworm larva, also COENURE [n]
COESITE	a type of silica (a form of silicon, also SILEX) [n -S]
COGENER	something of the same nature [n -S]
COGNATE	one that is related to another [n -S]
COHEIRS	COHEIR, a joint heir [n]
COIGNED	COIGNE, to secure with a type of wedge, also COIGN [v]
COINAGE	the act of making coins [n -S]
COINFER	to infer jointly [v COINFERRED, COINFERRING, COINFERS]
COLEADS	COLEAD, to lead jointly [v]
COLETIT	a bird of the tit family [n -S]
COMATES	COMATE, a companion [n]
COMRADE	a close friend [n -S]
CONARIA	CONARIUM, the pineal gland [n]
CONDIES	CONDIE, a tunnel, also CUNDY [n]
CONFIDE	to impart secrets in confidence [v CONFIDED, CONFIDING, CONFIDES]
CONGAED	CONGA, to perform a Latin American dance [v]
CONGEAL	to change from a fluid to a solid [v -ED, -ING, -S]
CONGERS	CONGER, a marine eel [n]
CONGEST	to fill to excess [v -ED, -ING, -S]
CONGREE	to agree (to have the same opinion) [v CONGREED, CONGREEING, CONGREES]
CONGRUE	to agree (to have the same opinion) [v CONGRUED, CONGRUING, CONGRUES]
CONIDIA	CONIDIUM, a fungus spore [n]
CONIFER	an evergreen tree [n -S]
CONIINE	a poisonous alkaloid, also CONIN, CONINE, CONICINE, CICUTINE [n -S]
CONINES	CONINE, a poisonous alkaloid, also CONIINE, CONIN, CONICINE, CICUTINE [n]
CONKIER	CONKY, full of a tree fungus [adj]
CONNATE	innate (inborn (existing in one from birth)) [adj]
CONNIES	CONNIE, a tram or bus conductor [n]
CONTAIN	to hold within [v -ED, -ING, -S]
CONTUSE	to bruise (to injure and discolour the skin) [v CONTUSED, CONTUSING, CONTUSES]
CONURES	CONURE, a type of small parrot [n]
CONVERT	to change into another form [v -ED, -ING, -S]
COOLIES	COOLIE, an Oriental labourer, also COOLY [n]
COONTIE	a tropical plant [n -S]
COORIED	COORIE, (Scots) to nestle or snuggle, also COURIE [v]
COORIES	COORIE, (Scots) to nestle or snuggle, also COURIE [v]
COOTERS	COOTER, a turtle [n]
COOTIES	COOTIE, a body louse [n]
COPIERS	COPIER, one that copies (to imitate (to copy)) [n]
COPSIER	COPSY, like a coppice [adj]
CORANTO	a rapid and lively dance [n CORANTOS or CORANTOES]
CORBEAU	a blackish green colour [n -S]
CORBEIL	a sculptured fruit basket [n -S]
CORBIES	CORBY, a raven, a crow, also CORBIE [n]
CORBINA	a food fish, also CORVINA [n -S]
CORDAGE	the amount of wood in an area [n -S]
CORDATE	heart-shaped [adj]
CORDIAL	a liqueur [n -S]
CORDITE	an explosive powder [n -S]
COREIGN	a joint reign [n -S]
COREMIA	COREMIUM, an organ of certain fungi [n]
CORNAGE	a feudal service [n -S]
CORNEAE	CORNEA, a part of the eye [n]
CORNEAL	relating to the eye [adj]
CORNELS	CORNEL, a hardwood tree or shrub, also CORNUS [n]
CORNETT	an old musical instrument [n -S]
CORNIER	CORNY, trite (hackneyed) [adj]
CORNUTE	to cuckold (to humiliate a man by seducing his wife) [v CORNUTED, CORNUTING, CORNUTES] / horn-shaped (pa t CORNUTED, CORNUTED) [adj]
CORONAE	CORONA, a luminous circle around a celestial body [n]
CORONEL	a wreath worn on the head, also CORONAL [n -S]
CORONET	a small crown, also CROWNET [n -S]
CORRADE	to erode (to wear away) [v CORRADED, CORRADING, CORRADES]
CORREAS	CORREA, an Australian evergreen shrub with large tubular showy flowers [n]
CORRIES	CORRIE, a deep basin on a mountain, also CIRQUE, CWM [n]
CORSAGE	a small bouquet of flowers [n -S]
CORSIVE	a corrosive [n -S]
CORTEGE	a retinue (a group of attendants) [n -S]
CORTILE	an enclosed courtyard [n CORTILI]
CORTINA	a membrane on some mushrooms [n -S]
CORVINA	a food fish, also CORBINA [n -S]
CORVINE	pertaining to the crow family of birds [adj]
COSMINE	a hard substance in fish scales, also COSMIN [n -S]
COSTATE	having ribs [adj]
COSTIVE	constipated [adj]
COTERIE	an exclusive circle [n -S]
COTIDAL	indicating coincidence of the tides [adj]
COTINGA	a bird with bright plumage [n -S]
COTTIER	a pin or a wedge, also COTTAR, COTTER [n -S]
COTTISE	to give a heraldic border, also COTISE [v COTTISED, COTTISING, COTTISES]
COTYLAE	COTYLE, an ancient Greek cup [n]
COULTER	a blade on a plow, also COLTER [n -S]
COUNTED	COUNT, to number (to count) [v]
COUNTER	to oppose (to conflict with) [v -ED, -ING, -S]
COURAGE	the quality that enables people to be brave [n -S]
COURANT	a lively dance, also COURANTE, COURANTO [n -S]
COURIED	COURIE, (Scots) to nestle or snuggle, also COORIE [v]
COURIER	a messenger\v to send by courier [n -S]
COURIES	COURIE, (Scots) to nestle or snuggle, also COORIE [v]
COURTED	COURT, to woo (to count (to number (to count))) [v]
COUTERS	COUTER, a piece of armour for the elbow [n]
COUTHIE	friendly, also COUTHY [adj COUTHIER, COUTHIEST]
COWIEST	COWY, suggestive of a cow [adj]
COWRIES	COWRIE, a glossy seashell, also COWRY [n]
COWRITE	to collaborate in writing [v COWROTE, COWRITTEN, COWRITING, COWRITES]
CRADLES	CRADLE, to hold lovingly [v]
CRANAGE	the use of a crane [n -S]
CRANIAL	pertaining to the skull [adj]
CRATING	CRATE, to put in a packing box [v]
CREASED	CREASE, to make a wrinkle in [v]
CREATED	CREATE, to bring into being [v]
CREATOR	one that creates (to bring into being) [n -S]
CREDENT	believing [adj]
CREEDAL	pertaining to a creed, also CREDAL [adj]
CREEING	pertaining to a creed (a statement of belief) [adj]
CREMANT	of wine, moderately sparkling [adj]
CREMATE	to reduce to ashes [v CREMATED, CREMATING, CREMATES]
CREMONA	an early woodwind instrument, also CRUMHORN, CROMORNE, CROMORNA, KRUMHORN [n -S]
CREOLES	CREOLE, a type of mixed language, also CREOLIAN [n]
CRINGED	CRINGE, to shrink in fear [v]
CRINGLE	a small loop of rope [n -S]
CROONED	CROON, to sing softly [v]
CROSIER	a bishop's staff, also CROZIER [n -S]
CROUTES	CROUTE, a thick slice of fried bread [n]
CROWDIE	porridge, also CROWDY [n -S]
CROWEAS	CROWEA, an Australian shrub with pink flowers [n]
CROWNET	a small crown, also CORONET [n -S]
CRUISED	CRUISE, to progress smoothly [v]
CRUNODE	a point at which a curve crosses itself [n -S]
CRUSADE	to engage in a holy war [v CRUSADED, CRUSADING, CRUSADES]
CRUSIAN	a type of fish [n -S]
CRUSTAE	CRUSTA, a hard coating [n]
CTENOID	comblike (like a comb) [adj]
CUITERS	CUITER, to wheedle (to entice by soft words, also WHILLY) [v]
CULTIER	CULTY, intended to appeal to a small group of fashionable people [adj]
CUNDIES	CUNDY, a tunnel, also CONDIE [n]
CUNEATE	wedge-shaped, also CUNEAL, CUNEATED, CUNEATIC [adj]
CURATED	CURATE, to act as a curator (a museum manager) [v]
CURATES	CURATE, to act as a curator (a museum manager) [v]
CURIETS	CURIET, a breastplate [n]
CURIOSA	pornographic books [n]
CURITES	CURITE, a radioactive mineral [n]
CURLIES	CURLI, Curled hairlike processes on the E. coli bacteria. No -S [n]
CURTAIL	to cut short [v -ED, -ING, -S]
CURTAIN	to furnish with hanging fabric [v -ED, -ING, -S]
CUTESIE	twee, also CUTESY [adj CUTESIER, CUTESIEST]
CUTLINE	a caption [n -S]
CYANIDE	to treat an ore with cyanid [v CYANIDED, CYANIDING, CYANIDES]
CYANISE	to turn into cyanide, also CYANIZE [v CYANISED, CYANISING, CYANISES]
CYANITE	a mineral, also KYANITE [n -S]
DACOITS	DACOIT, a member of an Indian robber gang, also DAKOIT [n]
DAEMONS	DAEMON, a demon (an evil spirit) [n]
DAIMONS	DAIMON, an attendant spirit [n]
DALETHS	DALETH, the fourth letter of the Hebrew alphabet, also DALED, DALEDH [n]
DAMOSEL	a maiden, also DAMOZEL [n -S]
DAMPIER	DAMPY, damp (moist (slightly wet)) [adj]
DANDLER	one that dandles (to fondle (to caress)) [n -S]
DAPSONE	a medicinal substance [n -S]
DAREFUL	brave (showing courage) [adj]
DARKNET	the collection of networks and other technologies that enable people to illegally share copyrighted digital files with little or no fear of detection [n -S]
DARTLED	DARTLE, to dart repeatedly [v]
DASHEEN	a tropical plant [n -S]
DASYURE	a flesh-eating mammal [n -S]
DATURIC	relating to datura [adj]
DAUBERS	DAUBER, one that daubs (to smear (to spread with something oily or sticky)) [n]
DAUBIER	DAUBY, smeary (smeared) [adj]
DAUNDER	to stroll (to walk in a leisurely manner) [v -ED, -ING, -S]
DAUNTED	DAUNT, to frighten, also DANT [v]
DAYTIME	day (the time between sunrise and sunset) [n -S]
DEACONS	DEACON, to read a hymn aloud [v]
DEADING	DEAD, to become numb (lacking feeling) [v]
DEAFENS	DEAFEN, to make deaf (lacking the sense of hearing) [v]
DEAIRED	DEAIR, to remove air from [v]
DEANERY	the office of a dean, also DEANSHIP [n DEANERIES]
DEARNLY	secretly [adj]
DEAVING	DEAVE, to deafen, also DEEVE [v]
DEBASER	one who debases (to lower or degrade) [n -S]
DEBATER	one who debates (to deliberate) [n -S]
DEBITOR	someone who owes a debt, also DEBTOR [n -S]
DEBONER	a bone remover [n -S]
DEBONES	DEBONE, to remove the bones from [v]
DECAGON	a ten-sided polygon [n -S]
DECALOG	the Ten Commandments [n -S]
DECANES	DECANE, a hydrocarbon [n]
DECARES	DECARE, a measure equal to ten ares, also DEKARE [n]
DECEITS	DECEIT, falseness [n]
DECIARE	a metric unit of area [n -S]
DECLARE	to make known clearly [v DECLARED, DECLARING, DECLARES]
DECLINE	to refuse (to decline to take or accept) [v DECLINED, DECLINING, DECLINES]
DECURIA	a group of ten soldiers, also DECURY [n -S]
DEEMING	DEEM, to believe (to accept as true) [v]
DEEVING	DEEVE, to deafen, also DEAVE [v]
DEEWANS	DEEWAN, an official in India [n]
DEFAULT	to fail to do something required [v -ED, -ING, -S]
DEFILER	one that defiles (to make dirty (soiled)) [n -S]
DEFINER	one that defines (to state the meaning of) [n -S]
DEFINES	DEFINE, to state the meaning of [v]
DEFLATE	to release the air or gas from [v DEFLATED, DEFLATING, DEFLATES]
DEGAMIS	DEGAMI, a tropical tree, also DEGAME [n]
DEIFEST	DEIF, deaf (Scots) [adj]
DEIFIER	one that deifies (to make a god of) [n -S]
DEIFORM	having the form of a god [adj]
DELAYER	one that delays (to put off to a later time) [n -S]
DELICTS	DELICT, an offense against civil law [n]
DELIVER	to distribute to the addressee [v -ED, -ING, -S]
DELTAIC	pertaining to a delta, also DELTIC [adj]
DELTOID	a shoulder muscle [n -S]
DEMAINE	treatment, also DEMAYNE, DEMEANE [n -S]
DEMEANS	DEMEAN, to lower in status [v]
DEMENTI	a denial (the act of denying (to declare to be untrue, also DENAY)) [n -S]
DEMERIT	to lower in status [v -ED, -ING, -S]
DEMETON	an insecticide [n -S]
DEMOING	DEMO, to demonstrate [v]
DEMONIC	characteristic of a demon, also DEMONIAN [adj]
DEMOTES	DEMOTE, to lower in rank [v]
DEMOTIC	pertaining to a form of Egyptian writing [adj]
DEMOUNT	to remove from a mounting [v -ED, -ING, -S]
DENOTED	DENOTE, to indicate (to point out) [v]
DENTARY	a bone of the lower jaw [n DENTARIES]
DENTOID	resembling a tooth (a hard, bonelike enamel-coated structure embedded in th jawbones) [adj]
DEODARA	an East Indian cedar, also DEODAR [n -S]
DEODATE	a gift to God [n -S]
DEONTIC	of ethics [adj]
DEORBIT	to come out of orbit [v -ED, -ING, -S]
DEPLANE	to get off an airplane [v DEPLANED, DEPLANING, DEPLANES]
DEPLORE	to regret strongly [v DEPLORED, DEPLORING, DEPLORES]
DEPONES	DEPONE, to testify under oath [v]
DEPOSAL	the act of deposing (to remove from office) [n -S]
DEPOSER	one that deposes (to remove from office) [n -S]
DERATED	DERATE, to relieve from some taxes [v]
DESMINE	the mineral stilbite [n -S]
DESPITE	to treat with contempt [v DESPITED, DESPITING, DESPITES]
DEUTZIA	an ornamental shrub [n -S]
DEVEINS	DEVEIN, to remove the dorsal vein of [v]
DEVIATE	to differ from normal ways [v DEVIATED, DEVIATING, DEVIATES]
DEVILET	a young devil, also DEVILING, DEVLING [n -S]
DEVIOUS	indirect (not straightforward) [adj]
DEVORES	DEVORE, something etched with devore [n]
DEVOTES	DEVOTE, to give oneself wholly to [v]
DEWATER	to remove water from [v -ED, -ING, -S]
DEWIEST	DEWY, covered with dew, also DEAWIE, DEAWY [adj]
DEXTRAN	a substitute for blood plasma [n -S]
DEXTRIN	a substance used as an adhesive, also DEXTRINE [n -S]
DHOOTIE	a loincloth worn by Indian men, also DHOOTI, DHOTI, DHUTI [n -S]
DIABASE	an igneous rock [n -S]
DIALECT	a language peculiar to a region [n -S]
DIAMINE	a chemical compound, also DIAMIDE, DIAMIN [n -S]
DIAPASE	a whole range of musical tones, also DIAPASON [n -S]
DIARIZE	to keep a diary, also DIARISE [v DIARIZED, DIARIZING, DIARIZES]
DIATOMS	DIATOM, any of a class of algae [n]
DIAZINE	a chemical compound, also DIAZIN [n -S]
DIAZOES	DIAZO, a type of photocopy [n]
DIAZOLE	a chemical compound [n -S]
DICTATE	to read aloud for recording [v DICTATED, DICTATING, DICTATES]
DICTIER	DICTY, snobbish (characteristic of a snob) [adj]
DIETHER	a chemical compound [n -S]
DILATED	DILATE, to make larger (great in size) [v]
DIMETER	a verse of two metrical feet, also DIPODY [n -S]
DINERIC	pertaining to the interface between two immiscible liquids [adj]
DINGOED	DINGO, to act cowardly [v]
DIOCESE	an ecclesiastical district [n -S]
DIOPTER	a measure of refractive power, also DIOPTRE [n -S]
DIOPTRE	a measure of refractive power, also DIOPTER [n -S]
DIORAMA	a three-dimensional exhibit [n -S]
DIOXANE	a toxic flammable solvent, also DIOXAN [n -S]
DIPHONE	a shorthand sign for a diphthong [n -S]
DIPOLAR	pertaining to dipole (a pair of equal and opposite electric charges) [adj]
DIREFUL	dreadful [adj]
DISCAGE	to free from a cage [v DISCAGED, DISCAGING, DISCAGES]
DISCANT	to sing, also DESCANT [v -ED, -ING, -S]
DISCURE	to find out, also DISCOVER, DISCOURE [v DISCURED, DISCURING, DISCURES]
DISPART	to separate (to keep apart) [v -ED, -ING, -S]
DISPONE	to make a legal transfer [v DISPONED, DISPONING, DISPONES]
DISPUTE	to argue about [v DISPUTED, DISPUTING, DISPUTES]
DISTYLE	a portico with two columns [n -S]
DIVERGE	to move in different directions from a point [v DIVERGED, DIVERGING, DIVERGES]
DIVINER	one that divines (to foretell by occult means) [n -S]
DIVORCE	to terminate the marriage contract [v DIVORCED, DIVORCING, DIVORCES]
DOCENTS	DOCENT, a university lecturer [n]
DOCILER	DOCILE, compliant [adj]
DODGIER	DODGY, evasive (tending to evade) [adj]
DOESKIN	the skin of a doe [n -S]
DOGBANE	a perennial herb [n -S]
DOGVANE	a small vane (a device for showing the direction of the wind) [n -S]
DOLLIER	one who wheels a trolley [n -S]
DOMAINE	a vineyard in Burgundy [n -S]
DOMAINS	DOMAIN, an area of control [n]
DOMATIA	DOMATIUM, a plant-structure that harbours mites [n]
DOMINEE	an Afrikaner church minister [n -S]
DOMINES	DOMINE, master [n]
DOMINIE	a clergyman [n -S]
DONATED	DONATE, to contribute [v]
DOOBIES	DOOBIE, a marijuana cigarette [n]
DOOBRIE	a thing whose name is unknown or temporarily forgotten, a what's-its-name, also DOOBREY [n -S]
DOOMIER	DOOMY, depressed [adj]
DOORMEN	DOORMAN, an door attendant [n]
DORMANT	a joist [n -S]
DORMICE	DORMOUSE, a small rodent (a gnawing mammal) [n]
DOUBTER	one who doubts (to be uncertain about) [n -S]
DOUCINE	a cornice moulding [n -S]
DOVELET	a small dove [n -S]
DOWAGER	a dignified elderly woman [n -S]
DOWLIER	DOWLY, (English dialect) dull, low-spirited [adj]
DOWNIER	DOWNY, fluffily soft, also DOWLNEY [adj]
DRACENA	a tropical plant, also DRACAENA [n -S]
DRACONE	a container used for transporting liquids by sea [n -S]
DRAFTEE	one that is drafted [n -S]
DRANTED	DRANT, to drone (to make a monotonous humming sound) [v]
DRAPIER	a draper (a dealer in cloth) [n -S]
DRASTIC	a severe purgative [n -S]
DRAWEES	DRAWEE, the person on whom a bill of exchange is drawn [n]
DRIBLET	a small drop of liquid, also DRIBBLET [n -S]
DRIVELS	DRIVEL, to let saliva flow from the mouth (pa t DRIVELED, DRIVELLED), also DRIBBLE, DROOL [v]
DROILED	DROIL, to drudge (to do hard, tedious work) [v]
DROPLET	a tiny drop [n -S]
DUCTILE	easily shaped [adj]
DULCITE	a saccharine substance derived from plants, also DULCITOL, DULCOSE [n -S]
DUODENA	DUODENUM, the first portion of the small intestine [n]
DURABLE	hardy (very sturdy) [adj]
DURAMEN	the central wood of a tree [n -S]
DURANCE	restraint by physical force [n -S]
DYELINE	a copy made by using the diazo method [n -S]
EAGERLY	in an eager manner [adv]
EARBUDS	EARBUD, a small earphone (a headphone) [n]
EARDROP	an earring (an ornament for the ear) [n -S]
EARFULS	EARFUL, as much gossip as one can stand [n]
EARLDOM	the rank of an earl [n -S]
EARLIKE	like an ear [adj]
EARLOBE	the soft lower part of the outer ear [n -S]
EARTHED	EARTH, to cover with soil [v]
EARWIGS	EARWIG, to bias someone against [v]
EATABLE	anything used as food [n -S]
EBONICS	American black slang as an object of academic study [n]
EBONIES	EBONY, a hard wood like stone, also EBON, HEBEN [n]
EBONISE	to stain black in imitation of ebony, also EBONIZE [v EBONISED, EBONISING, EBONISES]
EBONITE	a hard rubber [n -S]
EBRIETY	drunkenness [n EBRIETIES]
EBRIOSE	drunk (intoxicated) [adj]
ECHIDNA	the spiny anteater [n ECHIDNAS or ECHIDNAE]
ECHOIER	ECHOEY, full of echos [adj]
ECHOIST	a person who repeats another person's words [n -S]
ECONUTS	ECONUT, an environmentalist [n]
ECOTAGE	obstructive action in defense of the natural environment [n -S]
ECOTONE	a type of ecological zone [n -S]
ECOTOUR	a tour of a natural habitat [n -S]
ECTASIA	the lengthening of a short syllable, also ECTASIS [n -S]
ECTOPIA	abnormal displacement of body parts, also ECTOPY [n -S]
ECURIES	ECURIE, a team of motor racing cars [n]
EDACITY	gluttony (excessive eating) [n EDACITIES]
EDEMATA	EDEMA, an excessive accumulation of serous fluid [n]
EDICTAL	pertaining to edicts (an order proclaimed by authority) [adj]
EDIFIER	one who edifies (to enlighten) [n -S]
EDUCATE	to teach (to instruct (to teach)) [v EDUCATED, EDUCATING, EDUCATES]
EDUCTOR	one that educes (to draw out) [n -S]
EELPOUT	a marine fish [n -S]
EFTSOON	soon afterward, also EFTSOONS [adv]
EGALITY	the state of being equal, also EQUALITY, EGALITE [n EGALITIES]
EGOTISM	self-conceit [n -S]
EGOTIZE	to talk about oneself a lot, also EGOTISE [v EGOTIZED, EGOTIZING, EGOTIZES]
EIDETIC	a person with a photographic memory [n -S]
EIDOLIC	pertaining to an eidolon (a phantom (something existing in appearance only)) [adj]
EIKONES	EIKON, an icon (a symbol or image, also IKON) [n]
EINKORN	a variety of wheat [n -S]
EIRENIC	peaceful in purpose , also EIRENICAL, IRENIC, IRENICAL [adj]
EISWEIN	a sweet German wine [n -S]
ELANCED	ELANCE, to throw as a lance [v]
ELANCES	ELANCE, to throw as a lance [v]
ELAPINE	pertaining to a family of snakes [adj]
ELATIVE	a case form in some languages [n -S]
ELECTOR	one that elects (to select by vote) [n -S]
ELECTRO	to make an electroplate for printing [v -ED, -ING, -S]
ELEGIAC	a type of verse [n -S]
ELEVONS	ELEVON, a type of wing-flap [n]
ELOCUTE	to speak publicly [v ELOCUTED, ELOCUTING, ELOCUTES]
ELOGIUM	a funeral oration, also ELOGE, ELOGY [n -S]
ELOPERS	ELOPER, one who elopes (to run away to be married secretly) [n]
ELOPING	ELOPE, to run away to be married secretly [v]
ELYTRON	a hardened forewing of certain insects, also ELYTRUM [n ELYTRA]
EMAILED	EMAIL, to send electronic mail [v]
EMAILER	one who sends electronic messages via computer [n -S]
EMANATE	to send forth [v EMANATED, EMANATING, EMANATES]
EMBRAID	to braid, also EMBREAD [v -ED, -ING, -S]
EMBROIL	to involve in conflict [v -ED, -ING, -S]
EMERALD	a green gemstone, also EMERAUDE [n -S]
EMERITI	EMERITUS, a retired person who retains an honorary title [n]
EMERODS	EMEROD, a haemorrhoid, also EMEROID [n]
EMEROID	a haemorrhoid, also EMEROD [n -S]
EMETINE	an alkaloid which causes vomiting, also EMETIN [n -S]
EMICATE	to sparkle (to reflect flashes of light) [v EMICATED, EMICATING, EMICATES]
EMIGRES	EMIGRE, an emigrant (one that emigrates (to leave one's birthplace to settle in another)) [n]
EMINENT	of high station or rank [adj]
EMITTER	one that emits (to send forth) [n -S]
EMODINS	EMODIN, a chemical compound [n]
EMONGST	amongst, in the midst of, also EMONGEST [prep]
EMOTING	EMOTE, to show exaggerated emotion [v]
EMOTION	instinctive feeling as opposed to reason [n -S]
EMOTIVE	pertaining to emotion (instinctive feeling as opposed to reason) [adj]
EMPAIRE	to become worse, also EMPARE [v EMPAIRED, EMPAIRING, EMPAIRES]
EMPORIA	EMPORIUM, a large trading centre [n]
EMPTIER	one that empties (to remove the contents of) [n -S]
EMPTION	the act of buying [n -S]
EMULATE	to try to equal or surpass [v EMULATED, EMULATING, EMULATES]
EMULSIN	a type of enzyme (a complex protein, also ENZYM) [n -S]
EMURING	EMURE, to enclose behind walls, also IMMURE [v]
ENABLED	ENABLE, to make possible (capable of being true) [v]
ENABLER	one that enables (to make possible (capable of being true)) [n -S]
ENABLES	ENABLE, to make possible (capable of being true) [v]
ENACTED	ENACT, to establish by law [v]
ENACTOR	one that enacts (to establish by law) [n -S]
ENAMELS	ENAMEL, to cover with a vitrified coating [v]
ENAMINE	a type of amine (a type of chemical compound) [n -S]
ENAMOUR	to inspire with love, also ENAMOR [v -ED, -ING, -S]
ENARMED	ENARM, to arm (to supply with weapons) [v]
ENCAGED	ENCAGE, to put in a cage, also INCAGE [v]
ENCAGES	ENCAGE, to put in a cage, also INCAGE [v]
ENCASED	ENCASE, to put in a case, also INCASE [v]
ENCINAL	pertaining to an oak (a hardwood tree) [adj]
ENCINAS	ENCINA, an evergreen oak [n]
ENCLOSE	to surround, also INCLOSE [v ENCLOSED, ENCLOSING, ENCLOSES]
ENCODER	one that encodes (to put into code) [n -S]
ENCODES	ENCODE, to put into code [v]
ENCOMIA	ENCOMIUM, an address of praise, also ENCOMION [n]
ENCORED	ENCORE, to call for a repetition of a performance [v]
ENCORES	ENCORE, to call for a repetition of a performance [v]
ENCRATY	self-control [n ENCRATIES]
ENDGAME	the last stage of a board game [n -S]
ENDITED	ENDITE, to charge formally with a crime [v]
ENDIVES	ENDIVE, a salad herb [n]
ENDLEAF	an endpaper (a sheet of paper used in bookbinding) [n ENDLEAFS or ENDLEAVES]
ENDMOST	farthest [adj]
ENDOWER	one who endows (to bequeath, also INDOW) [n -S]
ENDOZOA	ENDOZOON, a parasite within, such as a tapeworm, also ENTOZOON [n]
ENDWISE	lengthwise [adj]
ENEMATA	ENEMA, fluid injected into the rectum [n]
ENERGIC	showing energy [adj]
ENFILED	in heraldry, thrust through like a sword [adj]
ENFIRED	ENFIRE, to inflame (to set on fire) [v]
ENFRAME	to put in a frame [v ENFRAMED, ENFRAMING, ENFRAMES]
ENGRACE	to put grace into [v ENGRACED, ENGRACING, ENGRACES]
ENGRAMS	ENGRAM, a deep-seated psychological impression, also ENGRAMMA, ENGRAMME [n]
ENGRASP	to grasp (to seize firmly with the hand) [v -ED, -ING, -S]
ENGRAVE	to carve a design upon [v ENGRAVED, ENGRAVEN, ENGRAVING, ENGRAVES]
ENLACED	ENLACE, to entwine or entangle, also INLACE [v]
ENLACES	ENLACE, to entwine or entangle, also INLACE [v]
ENLIGHT	to shed light on [v ENLIGHTED, ENLIT, ENLIGHTING, ENLIGHTS]
ENPRINT	an enlarged photograph [n -S]
ENQUIRE	to ask (to inquire or request) [v ENQUIRED, ENQUIRING, ENQUIRES]
ENRACED	ENRACE, to implant (to plant firmly) [v]
ENRIVEN	torn [adj]
ENROBED	ENROBE, to dress (to clothe (to provide with clothing)) [v]
ENROBER	one who enrobes (to dress (to clothe)) [n -S]
ENROBES	ENROBE, to dress (to clothe (to provide with clothing)) [v]
ENROUGH	to make rough (uneven (not even)) [v -ED, -ING, -S]
ENSLAVE	to make a slave of [v ENSLAVED, ENSLAVING, ENSLAVES]
ENTAMED	ENTAME, to tame (to subdue (to bring under control, also SUBDEW)) [v]
ENTAYLE	to carve (to form by cutting, also KERF, KERVE) [v ENTAYLED, ENTAYLING, ENTAYLES]
ENTHRAL	to hold spellbound [v ENTHRALLED, ENTHRALLING, ENTHRALS]
ENTICED	ENTICE, to lead astray [v]
ENTOMIC	pertaining to insects (a small invertebrate segmented animal) [adj]
ENTOPIC	in the usual place [adj]
ENTOTIC	pertaining to the ear's interior [adj]
ENTOZOA	ENTOZOAN, am entozoic parasite [n]
ENTRALL	old singular form of ENTRAILS (internal organs) [n ENTRALLES]
ENTROPY	a measure of unavailable energy [n ENTROPIES]
ENTWINE	to weave together, also INTWINE [v ENTWINED, ENTWINING, ENTWINES]
ENVAULT	to enclose in a vault [v -ED, -ING, -S]
ENVIOUS	jealous (envious of others, also GEALOUS) [adj]
ENVIRON	to encircle (to form a circle around) [v -ED, -ING, -S]
EOBIONT	a type of basic organism [n -S]
EOSINIC	pertaining to eosin (a red dye, also EOSINE) [adj]
EPACRID	an Australian plant resembling heath, also EPACRIS [n -S]
EPAULET	a shoulder ornament [n -S]
EPEIRID	a type of spider, also EPEIRA [n -S]
EPHORAL	relating to an ephor [adj]
EPIDOTE	a mineral [n -S]
EPIGEAL	growing close to the ground, also EPIGAEAL, EPIGEAN, EPIGEIC, EPIGEOUS [adj]
EPIGEAN	growing close to the ground, also EPIGEAL, EPIGAEAL, EPIGEIC, EPIGEOUS [adj]
EPIGONE	an inferior imitator, also EPIGON, EPIGONUS [n -S]
EPIGONI	EPIGONUS, an inferior imitator, also EPIGON, EPIGONE [n]
EPILATE	to remove hair [v EPILATED, EPILATING, EPILATES]
EPILOGS	EPILOG, a conclusion [n]
EPINAOI	EPINAOS, a rear vestibule [n]
EPISODE	a series of events forming digression [n -S]
EPITOME	a typical example [n -S]
EPIZOAN	an animal which lives on the surface of another, also EPIZOON [n -S]
EPURATE	to purify (to cleanse from impurities) [v EPURATED, EPURATING, EPURATES]
EQUATOR	an imaginary circle round the middle of the earth [n -S]
EQUINAL	pertaining to horses [adj]
EQUINIA	glanders, a contagious horse disease [n -S]
ERATHEM	the group of rock strata of a particular era [n -S]
ERECTOR	one that erects, also ERECTER [n -S]
EREMITE	a hermit, recluse [n -S]
ERETHIC	pertaining to erethism (abnormal irritability) [adj]
ERGODIC	pertaining to the recurring of any state [adj]
ERGOTIC	pertaining to ergot (a fungus (any of the major group of lower plants)) [adj]
ERIACHS	ERIACH, a murderer's fine in old Irish law, also ERIC, ERICK [n]
ERICOID	resembling heath (an evergreen shrub) [adj]
ERISTIC	an expert in debate [n -S]
ERMELIN	ermine (the white fur of the stoat) [n -S]
ERMINED	trimmed with ermine [adj]
ERODIUM	a plant of the geranium family [n -S]
EROSELY	in an uneven manner [adv]
EROSIVE	causing erosion [adj]
EROTEMA	a rhetorical question, also EROTEME, EROTESIS [n -S]
EROTEME	a rhetorical question, also EROTEMA, EROTESIS [n -S]
EROTICA	sexual literature [n]
EROTIZE	to give a sexual meaning to, also EROTISE [v EROTIZED, EROTIZING, EROTIZES]
ERRATIC	a large rock transported by glacier [n -S]
ERRHINE	a substance causing sneezing or nasal discharge [n -S]
ERYNGOS	ERYNGO, a medicinal herb, also ERINGO [n]
ESCOTED	ESCOT, to maintain financially [v]
ESLOYNE	to remove to a distant place, also ELOIN, ELOIGN, ESLOIN [v ESLOYNED, ESLOYNING, ESLOYNES]
ESTUARY	the tidal mouth of a large river [n ESTUARIES]
ETACISM	one way of pronouncing eta [n -S]
ETATISM	extreme state control over the individual, also ETATISME [n -S]
ETHANAL	another name for acetaldehyde [n -S]
ETHANOL	an alcohol (a flammable liquid) [n -S]
ETHERIC	like a spirit, also AETHEREAL, ETHEREAL, ETHERIAL [adj]
ETHICAL	a drug sold by prescription only [n -S]
ETHIOPS	an old name for various dingy chemicals [n -ES]
ETHMOID	a square bone at the root of the nose [n -S]
EUCAINE	an anaesthetic safer than cocaine, also EUCAIN [n -S]
EUCAINS	EUCAIN, an anaesthetic safer than cocaine, also EUCAINE [n]
EUCRITE	a stony meteorite [n -S]
EUDEMON	a good spirit, also EUDAEMON, EUDAIMON [n -S]
EUGENIC	pertaining to eugenics (the genetic improvement of a race by selective breeding) [adj]
EUOUAES	EUOUAE, a name for a Gregorian cadence, also EVOVAE [n]
EUPLOID	a cell with three or more genomes [n -S]
EUPNEAS	EUPNEA, normal breathing, also EUPNOEA [n]
EUPNOEA	normal breathing, also EUPNEA [n -S]
EUTAXIA	the property of being easily melted, also EUTEXIA [n -S]
EUTEXIA	the property of being easily melted, also EUTAXIA [n -S]
EVADERS	EVADER, one who evades (to escape or avoid by cunning) [n]
EVADING	EVADE, to escape or avoid by cunning [v]
EVANGEL	a preacher of the gospel [n -S]
EVANISH	to vanish (to disappear) [v -ED, -ING, -ES]
EVERTOR	a muscle that turns outwards [n -S]
EVICTOR	one who evicts (to dispossess by law) [n -S]
EVIDENT	something which serves as evidence [n -S]
EVITATE	to avoid, also EVITE [v EVITATED, EVITATING, EVITATES]
EVITING	EVITE, to avoid, also EVITATE [v]
EVOCATE	to evoke (to call forth) [v EVOCATED, EVOCATING, EVOCATES]
EVOLUTE	to develop by evolution [v EVOLUTED, EVOLUTING, EVOLUTES]
EXACTOR	one that exacts, also EXACTER [n -S]
EXALTER	one who exalts (to place in a high position) [n -S]
EXARATE	of pupae, containing grooves [adj]
EXCITON	a combination of excited electron and hole [n -S]
EXCITOR	one that excites, also EXCITER [n -S]
EXILIAN	pertaining to exile, also EXILIC [adj]
EXORDIA	EXORDIUM, a beginning [n]
EXOTICA	things excitingly different or unusual [n]
EYALETS	EYALET, a Turkish province [n]
EYELIAD	an amorous glance, also OEILLADE, ELIAD, EYLIAD, ILLIAD [n -S]
FACIEND	a number to be multiplied by another [n -S]
FACTION	a clique within a larger group [n -S]
FADAISE	a silly saying [n -S]
FADEOUT	a gradual disappearance of an image [n -S]
FADEURS	FADEUR, dullness (the state of being dull, also DULNESS) [n]
FAGOTED	FAGOT, to bind together in a bundle, also FAGGOT [v]
FAGOTER	one that fagots (to bind together in a bundle, also FAGGOT) [n -S]
FAHLORE	a copper ore, also FAHLERZ [n -S]
FAIENCE	a type of glazed pottery, also FAYENCE [n -S]
FAILURE	the act of failing [n -S]
FAINNES	FAINNE, a ring-shaped badge worn to show suport for the Irish language [n]
FAIRIES	FAIRY, a mythical small being [n]
FAITHED	FAITH, to believe or trust [v]
FAITHER	(Scots) father [n -S]
FAITORS	FAITOR, an imposter, also FAITOUR [n]
FAITOUR	an imposter, also FAITOR [n -S]
FANCIED	FANCY, to take a liking to [v]
FANCIER	one that has a special liking for something [n -S]
FANCIES	FANCY, to take a liking to [v]
FANNIED	FANNY, as in to fanny about, to procrastinate [v]
FANNIES	FANNY, as in to fanny about, to procrastinate [v]
FANTAIL	a fan-shaped tail or end [n -S]
FANTEEG	anxiety, also FANTIGUE [n -S]
FANWISE	spread out like an open fan [adj]
FARCIED	diseased with farcy (glanders) [adj]
FARCIES	FARCY, a chronic horse disease, also FARCIN [n]
FARDELS	FARDEL, a bundle [n]
FARINAS	FARINA, a fine meal made from cereal grain [n]
FARTING	FART, to expel gas through the anus [v]
FASCINE	a long faggot used for engineering purposes [n -S]
FATIGUE	to weary, also FATIGATE [v FATIGUED, FATIGUING, FATIGUES]
FATTIES	FATTY, one that is fat [n]
FAULTED	FAULT, to criticize [v]
FAUNIST	someone who studies fauna [n -S]
FAUREST	FAUR, far (Scots) [adj]
FAVORED	FAVOR, to regard with goodwill, also FAVOUR [v]
FAVRILE	an iridescent glassware [n -S]
FAWNIER	FAWNY, yellowish-brown color [adj]
FEALING	FEAL, to conceal (to hide (to conceal)) [v]
FEATHER	to cover with the plumage of birds [v -ED, -ING, -S]
FEATING	FEAT, to cover with feathers [v]
FEATOUS	shapely, also FEATEOUS, FEATUOUS [adj]
FEATURE	to present prominently [v FEATURED, FEATURING, FEATURES]
FEDARIE	an accomplice, also FEDERARY, FOEDARIE [n -S]
FEDERAL	a supporter of federation [n -S]
FEEDING	a calculated amount of food [n -S]
FEEDLOT	a plot of land in which livestock is fattened [n -S]
FEELING	the sense of touch [n -S]
FEERING	a first guiding furrow, also FEERIN [n -S]
FEESING	FEESE, to unsettle, also FAZE, FEASE, FEAZE, FEEZE, PHEESE, PHEEZE, PHESE [v]
FEIGNED	FEIGN, to pretend (to make believe) [v]
FEIGNER	one that feigns (to pretend (to make believe)) [n -S]
FEIJOAS	FEIJOA, an edible fruit [n]
FEINTED	FEINT, to make a pretence [v]
FELINES	FELINE, a member of the cat family, also FELID [n]
FELTIER	FELTY, matted like felt [adj]
FELTING	felted material [n -S]
FEMINAL	of a man, thinking like a women [adj]
FEMITER	a plant once used to treat scurvy, also FUMITORY, FEMETARY, FENITAR [n -S]
FEMORAL	pertaining to the femur [adj]
FENAGLE	to obtain by trickery, also FINAGLE [v FENAGLED, FENAGLING, FENAGLES]
FENDIER	FENDY, thrifty (economic (relating to finance)) [adj]
FENNIER	FENNY, having fens, also [adj]
FEODARY	a holder of land by feudal tenure for allegiance, also FEUDARY [n FEODARIES]
FERLIED	FERLY, to wonder, also FERLIE [v]
FERLIES	FERLIE, a strange sight, also FERLY [n]
FERMATE	FERMATA, the unspecified prolongation of note or rest [n]
FERMION	a type of atomic particle [n -S]
FERNIER	FERNY, abounding in ferns (a flowerless vascular plant) [adj]
FERRATE	a chemical salt [n -S]
FERRITE	a form of pure iron [n -S]
FERTILE	productive [adj FERTILER, FERTILEST]
FERULAE	FERULA, a flat piece of wood [n]
FERULAS	FERULA, a flat piece of wood [n]
FESTOON	to adorn with garlands [v -ED, -ING, -S]
FETIDER	FETID, stinking, also FOETID [adj]
FEUDIST	one that feuds (to engage in a persistent state of private enmity) [n -S]
FIACRES	FIACRE, a small carriage (a wheeled horse-drawn vehicle) [n]
FIANCEE	a woman engaged to be married [n -S]
FIANCES	FIANCE, a man engaged to be married [n]
FIAUNTS	FIAUNT, a judge's warrant [n]
FIBRATE	any of a group of chemical compounds that reduce levels of fat in the body [n -S]
FIBROSE	to form fibrous tissue [v FIBROSED, FIBROSING, FIBROSES]
FIELDER	one who catches or picks up a ball in play [n -S]
FILACER	an officer who filed writs, also FILAZER [n -S]
FILAREE	a European weed [n -S]
FILEMOT	a dull brown colour, also PHILAMOT, PHILOMOT [n -S]
FILETED	FILET, to cut boneless slices from, also FILLET [v]
FILIATE	to bring into close association [v FILIATED, FILIATING, FILIATES]
FINABLE	subject to the payment of a fine, also FINEABLE [adj]
FINAGLE	to obtain by trickery, also FENAGLE [v FINAGLED, FINAGLING, FINAGLES]
FIREDOG	a metal support for logs in a fireplace, also ANDIRON, ENDIRON [n -S]
FIRELIT	lit by firelight [adj]
FIREMAN	a man employed to extinguish fires [n FIREMEN]
FIREMEN	FIREMAN, a man employed to extinguish fires [n]
FIREPAN	a metal vessel for holding a fire [n -S]
FIREPOT	a pot with burning contents used as a missile [n -S]
FISTIER	FISTY, like a fist [adj]
FITLIER	FITLY, in a more fitting manner [adv]
FLAMIER	FLAMY, flaming [adj]
FLANEUR	a committed idler [n -S]
FLANGER	one that flanges (to provide with a protecting rim) [n -S]
FLANNIE	(Aust.) a shirt made of flannel or flannelette, also FLANNY [n -S]
FLARIER	FLARY, tending to flare [adj]
FLATTIE	a light flat shoe, also FLATTY [n -S]
FLAUNES	FLAUNE, a custard, also FLAWN, FLAMM [n]
FLAVINE	a yellow pigment, also FLAVIN [n -S]
FLAVONE	a pigment derived from plants such as primrose [n -S]
FLAWIER	FLAWY, full of flaws [adj]
FLEAPIT	a run-down movie theatre [n -S]
FLEEING	FLEE, to run away [v]
FLEURON	a flowerlike ornament [n -S]
FLINDER	a small fragment [n -S]
FLINGER	one that flings (to throw with force) [n -S]
FLINTED	FLINT, to provide with a spark-producing rock [v]
FLIRTED	FLIRT, to engage in amorous banter [v]
FLOATED	FLOAT, to rest or move on the surface of liquid [v]
FLOATER	one that floats (to rest or move on the surface of liquid) [n -S]
FLOOSIE	a prostitute, also FLOOSY, FLOOZIE, FLOOZY, FLOSSIE [n -S]
FLOREAT	may (a person, institution, etc.) flourish, plural FLOREANT [v]
FLORIER	FLORY, showy (making a brilliant display) [adj]
FLOTAGE	the act of floating, also FLOATAGE [n -S]
FLOUTER	one that flouts (to treat with contempt) [n -S]
FLUATES	FLUATE, a fluoride (a compound of fluorine, also FLUORID) [n]
FLUIEST	FLUEY, infected with the flu [adj]
FLUTIER	FLUTY, resembling a flute in sound, also FLUTEY [adj]
FLUTINA	a type of accordion [n -S]
FOALING	FOAL, to give birth to a horse [v]
FOAMERS	FOAMER, one that foams (to form froth or bubbles) [n]
FOAMIER	FOAMY, covered with foam [adj]
FOETORS	FOETOR, a stench, also FETOR [n]
FOLIAGE	the growth of leaves on a plant [n -S]
FOLIATE	to hammer into thin plates [v FOLIATED, FOLIATING, FOLIATES]
FOLIOED	FOLIO, to number the pages of [v]
FOLIOSE	having leaves, also FOLIOUS [adj]
FOMITES	FOMES, a substance capable of carrying infection, also FOMITE [n]
FONDEST	FOND, having an affection for [adj]
FONDLER	one that fondles (to caress (to touch lovingly)) [n -S]
FONTINA	an Italian cheese [n -S]
FOODIES	FOODIE, an enthusiast for food and its preparation, also FOODY [n]
FOOTAGE	measurement of payment by the foot [n -S]
FOOTERS	FOOTER, football (a type of ball) [n]
FOOTIER	FOOTY, paltry (petty (insignificant)) [adj]
FOOTIES	FOOTIE, a flirting game played with the feet, also FOOTSIE, FOOTSY [n]
FOOTLER	someone who footles [n -S]
FOOTSIE	a flirting game played with the feet, also FOOTIE, FOOTSY [n -S]
FORAGED	FORAGE, to search about [v]
FORAGES	FORAGE, to search about [v]
FORAMEN	a small anatomical opening [n FORAMENS or FORAMINA]
FORAYED	FORAY, to raid (to make a sudden assault on) [v]
FORBADE	FORBID, to command not to do something [v]
FORDONE	FORDO, to destroy (pa t FORDID), also FOREDO [v]
FOREGUT	the front part of the embryonic alimentary canal [n -S]
FOREIGN	situated outside a place or country [adj]
FORELAY	to wait in ambush [v FORELAID, FORELAIN, FORELAYING, FORELAYS]
FORELIE	to lie in front of [v FORELAY, FORELIES]
FOREMAN	a man who supervises workers [n FOREMEN]
FORERAN	FORERUN, to run in advance of [v]
FORESAW	FORESEE, to see in advance [v]
FORESAY	to predict (to foretell (to tell about in advance)) [v FORESAID, FORESAYING, FORESAYS]
FORGETS	FORGET, to fail to remember [v]
FORHENT	to overtake (pa t FORHENT), also FOREHENT [v -ING, -S]
FORLEND	to grant beforehand, also FORELEND [v -ING, -S]
FORLENT	FORELEND, to grant beforehand (pa t FORELENT, FORLENT), also FORLEND [v]
FORMATE	to fly in formation [v FORMATED, FORMATING, FORMATES]
FORNENT	directly opposite, also FORNENST, FERNINST [adv]
FORPINE	to waste away [v FORPINED, FORPINING, FORPINES]
FORSAID	FORSAY, to forbid (to command not to do something) [v]
FORTING	FORT, to fortify (to strengthen against attack) [v]
FORTUNE	to endow with wealth [v FORTUNED, FORTUNING, FORTUNES]
FORWENT	FORGO, to refrain from [v]
FOUDRIE	jurisdiction of a foud [n -S]
FOUGADE	a pit filled with explosives and stones, also FOUGASSE [n -S]
FOULIES	FOULIE, (Australian) a foul mood [n]
FOUNDER	to become disabled [v -ED, -ING, -S]
FOUTERS	FOUTER, to mess around, also FOUTRE [v]
FOUTRED	FOUTRE, to mess around, also FOUTER [v]
FOUTRES	FOUTRE, to mess around, also FOUTER [v]
FOVEATE	pertaining to a fovea (a shallow anatomical depression) [adj]
FRAGILE	easily broken [adj FRAGILER, FRAGILEST]
FRAILER	FRAIL, fragile (easily broken) [adj]
FRANION	a paramour (an illicit lover) [n -S]
FREEGAN	an opponent of consumerism who uses survives using recycled goods [n -S]
FREEING	FREE, to set at liberty [v]
FREEMAN	one who is free [n FREEMEN]
FRENULA	FRENULUM, a connecting fold of membrane (one pl FRENULA), also FRENUM, FRAENUM [n]
FRIABLE	easily crumbled [adj]
FRIANDS	FRIAND, an epicure (a gourmet (a connoisseur of fine food and drink)) [n]
FRIGATE	a sailing vessel [n -S]
FRINGED	FRINGE, to provide with an ornamental border [v]
FROGLET	a small frog, also FROGLING [n -S]
FRONTAL	a bone of the skull [n -S]
FRONTED	FRONT, to provide with a forward part [v]
FRONTER	someone who fronts an organisation? no -S [n pl.]
FRUITED	FRUIT, to produce an edible part of a plant [v]
FUNDIES	FUNDY, a radical within the German Green Party, also FUNDIE [n]
FUNERAL	a ceremony held to honour a dead person [n -S]
FURANES	FURANE, a chemical used in tanning, also FURAN, FURFURAN [n]
FUSTIAN	a cotton fabric [n -S]
FUSTIER	FUSTY, musty (having a stale odour) [adj]
FUTILER	FUTILE, ineffective [adj]
GABIONS	GABION, a basket of earth or stones used for fortification [n]
GAHNITE	a mineral [n -S]
GALENIC	pertaining to galena (an ore of lead) [adj]
GALILEE	a type of porch (a covered structure at the entrance of a building) [n -S]
GALIPOT	a type of turpentine [n -S]
GALLEIN	a green dye [n -S]
GALLEON	a large sailing vessel [n -S]
GALOPED	GALOP, to dance a galop (a lively round dance) [v]
GALOPIN	a kitchen boy [n -S]
GALOSHE	to put an overshoe over, also GALOSH, GALOCHE, GOLOSH [v GALOSHED, GALOSHING, GALOSHES]
GAMETES	GAMETE, a mature reproductive cell [n]
GAMIEST	GAMY, plucky, also GAMEY [adj]
GAMONES	GAMONE, a secretion which attracts another gamete [n]
GAPIEST	GAPY, infested with gapeworms [adj]
GARBOIL	turmoil [n -S]
GARVIES	GARVIE, a sprat, also GARVOCK [n]
GASEITY	gaseous state [n GASEITIES]
GATEMAN	a person in charge of a gate [n GATEMEN]
GATEMEN	GATEMAN, a person in charge of a gate [n]
GAUCIER	GAUCY, portly, also GAUCIE, GAWCY [adj]
GAUMIER	GAUMY, sticky (tending to adhere) [adj]
GAUZIER	GAUZY, resembling gauze (a transparent fabric) [adj]
GAWSIER	GAWSIE, well-fed and healthy looking, also GAWSY [adj]
GAZIEST	GAZY, given to gazing [adj]
GEFILTE	as in gefilte fish, a dish of fish stuffed with various ingredients, also GEFULLTE [adj]
GEMINAL	having two matching substituted groups on the same atom [adj]
GENERIC	a type of drug [n -S]
GENETIC	pertaining to genetics (the science of heredity) [adj]
GENEVAS	GENEVA, a liquor [n]
GENIZOT	GENIZAH, a room in a synagogue [n]
GEOMANT	one who divines from shapes [n -S]
GERMANE	relevant (pertaining to the matter at hand) [adj]
GERMANS	GERMAN, an elaborate dance [n]
GESTAPO	a secret-police organisation [n -S]
GETABLE	able to be got [adj]
GHERAOS	GHERAO, to coerce by physical means [v]
GHOULIE	a demon, also GHOUL [n -S]
GHRELIN	a gastrointestinal hormone produced by epithelial cells lining the fundus of the stomach [n -S]
GIANTRY	giant stories [n GIANTRIES]
GIFTEES	GIFTEE, one that receives a gift [n]
GILBERT	an electrical unit of induced magnetic force [n -S]
GIROLLE	an edible mushroom [n -S]
GIRTHED	GIRTH, to encircle (to form a circle around) [v]
GISARME	a medieval weapon [n -S]
GLACIER	a huge mass of ice [n -S]
GLAIKET	foolish, also GLAIKIT [adj]
GLAIVED	provided with a glaive (a sword) [adj]
GLAIVES	GLAIVE, a sword (a weapon with a long blade) [n]
GLANCER	one that glances (to look quickly) [n -S]
GLAZIER	someone that glazes, also GLAZER [n -S]
GLEAMER	one that gleams (to shine with a soft radiance) [n -S]
GLEBIER	GLEBY, cloddy (lumpy (full of lumps)) [adj]
GLEEMAN	a minstrel (a medieval musician) [n GLEEMEN]
GLOBATE	spherical, also GLOBATED [adj]
GLOMERA	GLOMUS, a type of vascular tuft [n]
GNASHER	one that gnashes (to grind the teeth together) [n -S]
GNAWERS	GNAWER, one that gnaws (to wear away by persistent biting) [n]
GOATISH	resembling a goat (a horned mammal) [adj]
GOLIATH	a person considered to be a giant [n -S]
GOMERAL	a fool, also GOMEREL, GOMERIL [n -S]
GOMERIL	a fool, also GOMERAL, GOMEREL [n -S]
GONADIC	pertaining to the gonad, also GONADAL, GONADIAL [adj]
GOOFIER	GOOFY, silly (showing a lack of common sense) [adj]
GOOPIER	GOOPY, sticky or gooey [adj]
GORHENS	GORHEN, the female red grouse [n]
GOURAMI	a food fish, also GORAMY, GURAMI [n GOURAMIS or GOURAMIES]
GOURMET	a connoisseur of fine food and drink [n -S]
GOVERNS	GOVERN, to rule or direct [v]
GOWANED	covered with gowans (daisies) [adj]
GRABENS	GRABEN, a depression of the earth's crust [n]
GRACILE	gracefully slender [adj]
GRAFTED	GRAFT, to unite with a growing plant by insertion, also GRAFF [v]
GRAPIER	GRAPY, resembling grapes, also GRAPEY [adj]
GRAPNEL	a type of anchor [n -S]
GRAVIES	GRAVY, juices from cooked meat [n]
GREATLY	in a great manner [adv]
GREAVED	fitted with a greave (a piece of armour for the leg) [adj]
GREAVES	GREAVE, to feel grief, also GRIEVE [v]
GRECISE	to provide with a Greek style, also GRECIZE, GRAECIZE, GRAECISE [v GRECISED, GRECISING, GRECISES]
GREMIAL	a lap cloth used by a bishop [n -S]
GREMLIN	a mischievous creature [n -S]
GRIECED	in heraldry, placed upon steps [adj]
GRIECES	GRIECE, a step, also GRECE, GRECIAN, GREECE, GREESE, GREESING, GRESE, GRESSING, GRIZE [n]
GRIEVED	GRIEVE, to feel grief, also GREAVE [v]
GRIEVES	GRIEVE, to feel grief, also GREAVE [v]
GRIFTED	GRIFT, to swindle (to take money or property from by fraudulent means) [v]
GRIVETS	GRIVET, a small monkey [n]
GROMETS	GROMET, a reinforcing ring of metal, also GROMMET, GRUMMET [n]
GROUPIE	a female follower of rock groups [n -S]
GROVETS	GROVET, a wrestling hold [n]
GROYNES	GROYNE, a structure which protects a shore from erosion [n]
GUNFIRE	the firing of guns [n -S]
GYRATED	GYRATE, to revolve or rotate [v]
HABITED	HABIT, to clothe (to provide with clothing) [v]
HABITUE	a frequent customer [n -S]
HADROME	xylem (a woody tissue in trees or plants, also XYLOGEN) [n -S]
HAEMOID	pertaining to the blood, also HAEMAL, HAEMATAL, HAEMIC, HEMAL, HEMATAL, HEMIC, HEMOID [adj]
HAGRIDE	to harass (to bother persistently) [v HAGRODE, HAGRIDDEN, HAGRIDING, HAGRIDES]
HAGRODE	HAGRIDE, to harass (to bother persistently) [v]
HAILIER	HAILY, with hail falling [adj]
HAIRDOS	HAIRDO, a style of wearing the hair [n]
HAIRIER	HAIRY, covered with hair [adj]
HALOGEN	a non metallic element [n -S]
HALOIDS	HALOID, a chemical salt [n]
HALOING	HALO, to form a ring of light [v]
HALTERE	a pair of wings of an insect [n -S]
HANDLER	one who handles (to touch with the hands) [n -S]
HANDLES	HANDLE, to touch with the hands [v]
HANDSEL	to give a good luck gift to, also HANSEL [v HANDSELLED, HANDSELLING, HANDSELS]
HANGERS	HANGER, one that hangs (to suspend (to stop for a period)) [n]
HAPLITE	a fine-grained rock [n -S]
HAPTENE	a substance similar to an antigen, also HAPTEN [n -S]
HARDIER	HARDY, very sturdy [adj]
HARELDS	HARELD, the long-tailed duck [n]
HARELIP	a deformity of the upper lip [n -S]
HARICOT	the seed of various string beans [n -S]
HARMINE	an alkaloid used as a stimulant, also HARMALIN, HARMIN [n -S]
HARRIED	HARRY, to plunder (to rob by force) [v]
HARRIES	HARRY, to plunder (to rob by force) [v]
HAULERS	HAULER, one that hauls (to pull with force) [n]
HAULIER	a hauler (one that hauls (to pull with force)) [n -S]
HAUNTED	HAUNT, to visit frequently [v]
HAUNTER	one that haunts (to visit frequently) [n -S]
HAVEOUR	behaviour, also HAVIOUR [n -S]
HAYIEST	HAYEY, like hay [adj]
HAYRIDE	a wagon ride [n -S]
HEADERS	HEADER, a grain harvester [n]
HEADIER	HEADY, intoxicating [adj]
HEADING	a title [n -S]
HEADPIN	a bowling pin [n -S]
HEADRIG	a headland in a ploughed field [n -S]
HEALING	the process of getting better [n -S]
HEAPIER	HEAPY, full of heaps [adj]
HEARSED	HEARSE, to transport in a vehicle for carrying corpses [v]
HEARTED	HEART, to hearten (to give courage to, also HARTEN) [v]
HEATING	the provision of heat for a building [n -S]
HEAVIER	HEAVY, weighty (having a great weight) [adj]
HEAVIES	HEAVY, a villain (a malevolent evil-doer, also VILLAN) [n]
HEBONAS	HEBONA, anything with a poisonous juice, also HEBENON [n]
HECTARE	a unit of area [n -S]
HEDERAL	pertaining to a particular ivy genus [adj]
HEDERAS	HEDERA, ivy (a climbing vine) [n]
HEDGIER	HEDGY, abounding in hedges [adj]
HEDONIC	pertaining to pleasure [adj]
HEEDING	HEED, to pay attention to [v]
HEELING	the act of inclining laterally [n -S]
HEFTIER	HEFTY, heavy (weighty (having a great weight)) [adj]
HEGARIS	HEGARI, a grain [n]
HEGIRAS	HEGIRA, an exodus, also HEJIRA, HIJRA, HIJRAH [n]
HEINIES	HEINIE, the buttocks [n]
HEINOUS	very wicked [adj]
HEIRDOM	heirship (the right of inheritance) [n -S]
HEIRING	HEIR, to inherit (to receive by legal succession) [v]
HEISTED	HEIST, to steal (to take by theft) [v]
HELICON	a large brass tuba [n -S]
HELIMAN	a helicopter operator [n HELIMEN]
HEMIOLA	a perfect fifth, also HEMIOLIA [n -S]
HEMIONE	an Asiatic wild ass [n -S]
HENNIER	HENNY, hen-like [adj]
HENOTIC	tending to unify [adj]
HEPARIN	a biochemical [n -S]
HEPTANE	a hydrocarbon used as a solvent [n -S]
HERALDS	HERALD, to proclaim (to make known) [v]
HERDING	HERD, to bring together a group of animals [v]
HERETIC	one that upholds heresy [n -S]
HERITOR	one that inherits (to receive by legal succession) [n -S]
HERLING	a young sea-trout [n -S]
HERNIAE	HERNIA, the protrusion of an organ through its wall [n]
HEROICS	HEROIC, an epic verse [n]
HEROINE	a brave woman [n -S]
HEROISE	to make heroic, also HEROIZE [v HEROISED, HEROISING, HEROISES]
HEROISM	heroic behaviour [n -S]
HEROONS	HEROON, a temple dedicated to a hero [n]
HETAERA	a Greek courtesan, also HETAIRA [n HETAERAS or HETAERAE]
HETAIRA	a Greek courtesan [n HETAIRAS or HETAIRAI]
HICATEE	a freshwater tortoise [n -S]
HIDAGES	HIDAGE, a type of land tax [n]
HIDEOUS	ghastly (terrifying) [adj]
HIDEOUT	a place of refuge [n -S]
HIELAND	characteristic of Highlanders esp in respect of supposed gullibility [adj]
HIRABLE	available for hire, also HIREABLE [adj]
HIRAGES	HIRAGE, the fee for hiring something, also HIREAGE [n]
HIREAGE	the fee for hiring something, also HIRAGE [n -S]
HIRSLED	HIRSLE, to slide along [v]
HIRSTIE	dry (having no moisture) [adj]
HIRSUTE	hairy (covered with hair) [adj]
HOAGIES	HOAGIE, a long sandwich, also HOAGY [n]
HOARDER	one that hoards (to gather and store away) [n -S]
HOARIER	HOARY, white with age [adj]
HOARING	HOAR, to make hoary (white with age) [v]
HOARSER	HOARSE, rough and husky in sound [adj]
HOGTIED	HOGTIE, to tie the legs together [v]
HOGTIES	HOGTIE, to tie the legs together [v]
HOIDENS	HOIDEN, to act like a tomboy, also HOYDEN [v]
HOMIEST	HOMY, homelike, also HOMEY [adj]
HOMINES	HOMO, man generically [n]
HONGIED	HONGI, to greet with a traditional Maori greeting (nose to nose) [v]
HONORED	HONOR, to treat with respect, also HONOUR [v]
HONOREE	a person receiving an honor, also HONORAND [n -S]
HOODIER	HOODY, resembling a hoodlum (a thug (a brutal ruffian)) [adj]
HOODIES	HOODIE, a hoodie crow [n]
HOOLIER	HOOLY, soft and careful [adj]
HOOLIES	HOOLIE, a lively party [n]
HOOTERS	HOOTER, one that hoots (to cry like an owl) [n]
HOOTIER	HOOTY, sounding like the cry of an owl [adj]
HOPLITE	a Greek foot-soldier [n -S]
HORDEIN	a simple protein [n -S]
HORNIER	HORNY, like horn [adj]
HORNITO	a mound of volcanic matter [n -S]
HORNLET	a little horn [n -S]
HORRENT	bristling [adj]
HORSIER	HORSEY, resembling a horse [adj]
HOSEMAN	a fireman who directs the stream of water [n HOSEMEN]
HOSIERY	stockings or socks [n HOSIERIES]
HOSTAGE	a person held as security [n -S]
HOTTIES	HOTTIE, a hot-water bottle, a sexually attractive person, also HOTTY [n]
HOUNDER	one who hounds (to pursue relentlessly) [n -S]
HOUSIER	HOUSEY, typical of house music (disco mixes) [adj]
HUITAIN	a group of eight lines of verse [n -S]
HURDIES	the buttocks [n]
HURLIES	HURLY, a large two-wheeled barrow [n]
HYALINE	a transparent substance, also HYALIN [n -S]
HYALITE	a colourless opal [n -S]
HYDRIAE	HYDRIA, a water jar [n]
HYENOID	pertaining to a hyena (a wolflike mammal) [adj]
ICEBOAT	a vehicle that sails on ice [n -S]
ICONISE	to venerate, also ICONIZE [v ICONISED, ICONISING, ICONISES]
ICTERID	an American oriole [n -S]
ICTERUS	a diseased condition of the liver [n -ES]
IDEATED	IDEATE, to form an idea [v]
IDEATUM	the real object of an idea [n IDEATA]
IDENTIC	identical [adj]
IGARAPE	a canoe waterway in Brazil [n -S]
IGNOBLE	unworthy (not worthy) [adj IGNOBLER, IGNOBLEST]
IMAGERS	IMAGER, one that images (to form a likeness of mentally) [n]
IMAGINE	to form a mental picture of [v IMAGINED, IMAGINING, IMAGINES]
IMAGOES	IMAGO, an adult insect [n]
IMITATE	to copy (to imitate) [v IMITATED, IMITATING, IMITATES]
IMPALER	one that impales (to pierce with a pointed object) [n -S]
IMPANEL	to put onto a list for jury duty (pa t IMPANELED, IMPANELLED), also IMPANNEL [v IMPANELLED, IMPANELLING, IMPANELS]
IMPASTE	to lay colours on thickly [v IMPASTED, IMPASTING, IMPASTES]
IMPEARL	to make pearl-like [v -ED, -ING, -S]
IMPEDOR	an electrical component which offers impedance, cf resistor [n -S]
IMPERIA	IMPERIUM, absolute power [n]
IMPLATE	to put a covering plate over [v IMPLATED, IMPLATING, IMPLATES]
IMPLORE	to entreat (to beg for) [v IMPLORED, IMPLORING, IMPLORES]
IMPONED	IMPONE, to wager (to make a bet) [v]
IMPONES	IMPONE, to wager (to make a bet) [v]
IMPOSER	one who imposes (to set as a burden or task) [n -S]
INANELY	in an inane manner [adv]
INBOARD	a type of motor boat [n -S]
INBREAK	a violent rush in [n -S]
INBREED	to breed closely related stock [v INBRED, INBREEDING, INBREEDS]
INCAGED	INCAGE, to put in a cage, also ENCAGE [v]
INCAVED	INCAVE, to secrete, also ENCAVE [v]
INCAVES	INCAVE, to secrete, also ENCAVE [v]
INCEDES	INCEDE, to advance majestically [v]
INCHASE	to place in an ornamental border, also ENCHASE [v INCHASED, INCHASING, INCHASES]
INCITED	INCITE, to arouse to action [v]
INCLUDE	to take in as part of a whole [v INCLUDED, INCLUDING, INCLUDES]
INCOMER	one that comes in [n -S]
INCOMES	INCOME, money earned regularly [n]
INCONIE	delicate and pretty, also INCONY [adj]
INCUDES	INCUS, a bone in the middle ear [n]
INCUSED	INCUSE, to mark by stamping [v]
INDEXAL	pertaining to an index (a type of reference guide in a book) [adj]
INDEXER	one that indexes (to provide with an index) [n -S]
INDRAFT	an inward flow or current [n -S]
INDUCER	one that induces (to persuade (to induce by reasoning or entreaty, also PERSWADE)) [n -S]
INDUCES	INDUCE, to persuade (to induce by reasoning or entreaty, also PERSWADE) [v]
INDWELT	INDWELL, to live within [v]
INERTLY	in an inert manner [adv]
INEXACT	not exact or precise [adj]
INFAMED	INFAME, to defame (to destroy the reputation of) [v]
INFANTE	a younger son of a Portuguese or Spanish monarch [n -S]
INFAUST	unlucky (not lucky) [adj]
INFERNO	a place of horror and confusion [n -S]
INFLAME	to set on fire [v INFLAMED, INFLAMING, INFLAMES]
INFORCE	to compel, also ENFORCE [v INFORCED, INFORCING, INFORCES]
INFULAE	INFULA, a headband used during Roman rites [n]
INFUSED	INFUSE, to permeate (to spread through) [v]
INFUSER	one that infuses (to permeate (to spread through)) [n -S]
INGLOBE	to form into a globe, also ENGLOBE [v INGLOBED, INGLOBING, INGLOBES]
INGRAFT	to graft for propagation, also ENGRAFT [v -ED, -ING, -S]
INHALED	INHALE, to take into the lungs [v]
INHAUST	to drink in [v -ED, -ING, -S]
INHERCE	to enclose in a hearse, also INHEARSE, ENHEARSE [v INHERCED, INHERCING, INHERCES]
INHERED	INHERE, to be an essential characteristic [v]
INLACED	INLACE, to entwine or entangle, also ENLACE [v]
INNERVE	to stimulate [v INNERVED, INNERVING, INNERVES]
INOCULA	INOCULUM, the material used in an inoculation [n]
INORBED	INORB, to encircle (to form a circle around) [v]
INPHASE	having matching electrical phases [adj]
INQUERE	to ask about, also INQUIRE [v INQUERED, INQUERING, INQUERES]
INSCAPE	the essential inner nature of persons, objects etc [n -S]
INSPIRE	to influence to greater heights [v INSPIRED, INSPIRING, INSPIRES]
INTHRAL	to charm, also ENTHRALL, INTHRALL [v INTHRALLED, INTHRALLING, INTHRALS]
INTIMAL	pertaining to intima (the innermost layer of an organ) [adj]
INTIMAS	INTIMA, the innermost layer of an organ [n]
INVITAL	not vital [adj]
INVITED	INVITE, to request the presence of [v]
INVITEE	one who is invited [n -S]
INVOICE	to bill (to send charges to) [v INVOICED, INVOICING, INVOICES]
INVOKER	one who invokes (to appeal to for help, also INVOCATE) [n -S]
INWARDS	inward (towards the inside) [adv]
INWEAVE	to weave in [v INWOVE or INWEAVED, INWOVEN, INWEAVING, INWEAVES]
IODATED	IODATE, to treat with iodine, also IODINATE [v]
IODIZER	one that iodizes, also IODISER [n -S]
IONIZED	IONIZE, to convert into ions, also IONISE [v]
IONIZER	something that ionizes, also IONISER [n -S]
IONIZES	IONIZE, to convert into ions, also IONISE [v]
IONOMER	a type of plastic (a synthetic mouldable substance) [n -S]
IPOMOEA	a flowering plant [n -S]
IRACUND	easily angered [adj]
IRENICS	the theology of promoting peace between churches [n]
IRONIZE	to satirize with irony, also IRONISE [v IRONIZED, IRONIZING, IRONIZES]
IRONMAN	a man of great strength and stamina [n IRONMEN]
IRONMEN	IRONMAN, a man of great strength and stamina [n]
ISAGOGE	an academic introduction to a subject [n -S]
ISLEMEN	ISLEMAN, an islander, also ISLESMAN [n]
ISOBASE	a contour line of equal upheaval of the land [n -S]
ISOGRAM	a map line indicating points of equal value, also ISOLINE [n -S]
ISOHYET	a map line indicating points of equal rainfall [n -S]
ISOMERE	an organ corresponding with another [n -S]
ISONOME	a line connecting points where a species is equally abundant [n -S]
ISOTOPE	a form of an element [n -S]
ISOTYPE	a type of diagram [n -S]
ITEMING	ITEM, to set down the particulars of, also ITEMISE, ITEMIZE [v]
ITEMISE	to set down the particulars of, also ITEM, ITEMIZE [v ITEMISED, ITEMISING, ITEMISES]
IVORIED	made like ivory [adj]
IVORIES	IVORY, a hard white substance found in elephant tusks [n]
JACONET	a cotton cloth [n -S]
JADEITE	a mineral [n -S]
JANITOR	a caretaker [n -S]
JAUNTEE	briskly self-assured, also JANTY, JAUNTY, JANTEE [adj]
JAUNTIE	a naval master-at-arms [n -S]
JEOFAIL	the acknowledgement of a mistake [n -S]
JOINDER	a joining of parties in a law suit [n -S]
JOINERY	the trade of a joiner [n JOINERIES]
JOINTED	JOINT, to fit together [v]
JOLTIER	JOLTY, jerky (spasmodic) [adj]
JOTTIER	JOTTY, written down quickly [adj]
KAINITE	a mineral salt, also KAINIT [n -S]
KANTELE	a Finnish zither, also KANTELA [n -S]
KARENGO	(New Zealand) an edible seaweed [n -S]
KAURIES	KAURY, a timber tree, also KAURI [n]
KEITLOA	the rhinoceros [n -S]
KENOTIC	pertaining to kenosis (Christ's acceptance of his human nature) [adj] / someone who promulgates the idea of kenosis [n -S]
KETONES	KETONE, a type of chemical compound [n]
KETONIC	pertaining to ketone (a type of chemical compound) [adj]
KNAIDEL	in Jewish cookery, a dumpling, also KNEIDEL [n KNAIDLACH or KNEIDLACH]
KNEADER	one who kneads (to massage with the hands) [n -S]
KOORIES	KOORI, an Australian aborigine [n]
KYANITE	a mineral, also CYANITE [n -S]
LABIATE	a plant with liplike parts [n -S]
LABORED	LABOR, to work, also LABOUR [v]
LABORER	one who labors, also LABOURER [n -S]
LABROID	a marine fish [n -S]
LACTEAN	resembling milk, also LACTEOUS [adj]
LACTONE	a cyclic ester [n -S]
LACUNES	LACUNE, an empty space or missing part, also LACUNA [n]
LAICISE	to free from clerical control, also LAICIZE [v LAICISED, LAICISING, LAICISES]
LAIGHER	LAIGH, sunken, also LAICH [adj]
LAIRIZE	to act like a flashy man, also LAIRISE [v LAIRIZED, LAIRIZING, LAIRIZES]
LAMBIER	LAMBY, resembling a lamb [adj]
LAMETER	a cripple, also LAMIGER, LAMITER, LAMMIGER [n -S]
LAMIGER	a cripple, also LAMETER, LAMITER, LAMMIGER [n -S]
LAMINAE	LAMINA, a thin plate or layer, also LAMELLA [n]
LAMINAR	pertaining to a lamina, also LAMINARY [adj]
LANDLER	a slow Austrian dance [n -S]
LANIARY	a pointed conical tooth [n LANIARIES]
LARMIER	a course serving as a drip-stone [n -S]
LARVATE	masked, also LARVATED [adj]
LATENCE	hidden [n -S]
LATHEES	LATHEE, a heavy stick used as a weapon [n]
LATTICE	to form a network of crossed laths or bars [v LATTICED, LATTICING, LATTICES]
LAUNCED	LAUNCE, to pierce (to thrust, or make a hole through) [v]
LAUNCES	LAUNCE, to pierce (to thrust, or make a hole through) [v]
LAUWINE	an avalanche, also LAWINE [n -S]
LAYERED	LAYER, to form a single thickness [v]
LAYOVER	a stopover (a brief stop in the course of a journey, also STOPOFF) [n -S]
LAYTIME	the total time allowed [n -S]
LEADMEN	LEADMAN, a worker in charge of other workers [n]
LEAFIER	LEAFY, abounding in leaves [adj]
LEAFING	LEAF, to turn pages rapidly [v]
LEAKIER	LEAKY, inclined to leak [adj]
LEAKING	LEAK, to seep through [v]
LEAMING	LEAM, to shine (to emit light) [v]
LEAPING	LEAP, to spring off the ground [v]
LEASOWE	to pasture, also LEASOW [v LEASOWED, LEASOWING, LEASOWES]
LEATHER	to cover with the tanned hide of an animal [v -ED, -ING, -S]
LEAVENS	LEAVEN, to produce fermentation in [v]
LEAVIER	LEAVY, leafy (abounding in leaves) [adj]
LEAVING	a leftover (an unused portion) [n -S]
LECTERN	a reading desk [n -S]
LECTURN	a reading desk [n -S]
LEEPING	LEEP, to boil (to vaporize liquid) [v]
LEEWARD	the direction toward which the wind is blowing [n -S]
LEGHORN	a smooth, plaited straw [n -S]
LEGWEAR	anything worn on the legs [n -S]
LEISHER	LEISH, supple (pliant (easily bent)) [adj]
LEMONED	LEMON, to flavour with the juice of a citrus fruit [v]
LEMPIRA	a monetary unit of Honduras [n -S]
LEOPARD	a large, carnivorous, feline mammal [n -S]
LEPORID	a gnawing mammal [n -S]
LEPROSE	affected with leprosy, also LEPROUS, LEPROTIC [adj]
LEPTONS	LEPTON, a monetary unit of Greece [n]
LETDOWN	a decrease [n -S]
LETHEAN	pertaining to lethe (forgetfulness) [adj]
LETHIED	affected by lethe [adj]
LEUCINE	an amino acid, also LEUCIN [n -S]
LEUCINS	LEUCIN, an amino acid, also LEUCINE [n]
LEUCITE	a mineral [n -S]
LEVATOR	a muscle that raises [n LEVATORS or LEVATORES]
LEVIERS	LEVIER, one who levies (to impose or collect by legal authority) [n]
LEWISIA	a perennial herb [n -S]
LIBATED	LIBATE, to pour in honour to [v]
LICENSE	to issue or grant authoritative permission to, also LICENCE [v LICENSED, LICENSING, LICENSES]
LICENTE	SENTE, a monetary unit of Lesotho, pl LICENTE or LISENTE [n]
LIGHTEN	to reduce the weight of [v -ED, -ING, -S]
LIGHTER	to convey in a type of barge [v -ED, -ING, -S]
LIMBATE	having an edge of a different colour [adj]
LIMEADE	a beverage (any liquid for drinking) [n -S]
LIMITER	one who limits, also LYMITER [n -S]
LINECUT	a type of printing plate [n -S]
LINEMAN	one who installs or repairs telephone wires [n LINEMEN]
LINEUPS	LINEUP, a row of persons [n]
LINKAGE	the act of linking (to connect (to join together)) [n -S]
LIONIZE	to treat as a celebrity, also LIONISE [v LIONIZED, LIONIZING, LIONIZES]
LIQUATE	to purify metal by heating [v LIQUATED, LIQUATING, LIQUATES]
LIRIOPE	a stemless Asian herb [n -S]
LITHATE	a urate (a chemical salt) [n -S]
LITHOED	LITHO, to make prints by lithography [v]
LITORAL	pertaining to a coastal region [adj]
LIVENED	LIVEN, to make lively (full of energy) [v]
LIVENER	one who livens (to make lively (full of energy)) [n -S]
LIVERED	LIVER, to thicken or gel [v]
LLANERO	an inhabitant of the llanos [n -S]
LOAFING	the act of idling (to be unoccupied) [n -S]
LOAMIER	LOAMY, resembling loam [adj]
LOAMING	LOAM, to cover with loose soil [v]
LOATHED	LOATHE, to detest (to hate intensely) [v]
LOATHER	one who loathes (to detest (to hate intensely)) [n -S]
LOAVING	LOAVE, to form a head as in a cabbage [v]
LOBATED	having lobes, also LOBATE [adj]
LOBEFIN	a bony fish [n -S]
LOBELIA	a flowering plant [n -S]
LOCATED	LOCATE, to find or pinpoint [v]
LOCATER	one who locates, also LOCATOR [n -S]
LOFTIER	LOFTY, very high [adj]
LOGLINE	a line for finding the speed of a vessel [n -S]
LOMENTA	LOMENTUM, a type of plant pod, also LOMENT [n]
LOMENTS	LOMENT, a type of plant pod, also LOMENTUM [n]
LOOBIER	LOOBY, clumsy or stupid [adj]
LOOBIES	LOOBY, a large, awkward person [n]
LOOPIER	LOOPY, full of loops [adj]
LORICAE	LORICA, the case or shell of a protozoan [n]
LORIMER	a maker of implements for harnesses and saddles, also LORINER [n -S]
LOVAGES	LOVAGE, a perennial herb [n]
LOVERED	having a love [adj]
LOWERED	LOWER, to appear dark and threatening [v]
LUCARNE	a type of window [n -S]
LUCIDER	LUCID, easily understood [adj]
LUCITES	LUCITE, an acrylic resin or plastic consisting essentially of polymerized methyl methacrylate [n]
LUETICS	LUETIC, one infected with syphilis [n]
LUMINED	LUMINE, to light up [v]
LUMINES	LUMINE, to light up [v]
LUNATIC	an insane person [n -S]
LUNYIES	LUNYIE, the loin (meat from the lower part of an animal's back) [n]
LUPINES	LUPINE, a flowering plant, also LUPIN [n]
LUSHIER	LUSHY, tipsy (slightly drunk) [adj]
LUTHERN	a type of window [n -S]
LUTHIER	one who makes stringed instruments [n -S]
LYRATED	having the shape of a lyre, also LYRATE, LYRIFORM [adj]
MADEIRA	a white wine [n -S]
MADISON	a type of cyle relay race [n -S]
MADRONE	an evergreen tree, also MADRONA, MADRONO [n -S]
MAGENTA	a purplish red dye [n -S]
MAGNATE	a powerful or influential person [n -S]
MAGNETO	a type of electric generator [n -S]
MAGNETS	MAGNET, a metal that attracts iron, also MAGNETIC [n]
MAIGRES	MAIGRE, a large Mediterranean food fish [n]
MAINOUR	act or fact of theft, also MAINOR [n -S]
MAINTOP	a platform at the head of a mainmast [n -S]
MALAISE	a feeling of debility [n -S]
MALEATE	a chemical salt [n -S]
MALISON	a curse [n -S]
MALTEDS	MALTED, a sweet beverage [n]
MALTESE	as in maltese cross, a mechanism providing intermittent frame-by-frame movement in a motion picture film projector [adj]
MANAGER	one who manages (to control or direct) [n -S]
MANATEE	a large aquatic mammal, also MANATI [n -S]
MANATIS	MANATI, a large aquatic mammal, also MANATEE [n]
MANDATE	to command (to order (to give a command to)) [v MANDATED, MANDATING, MANDATES]
MANDIRA	a Hindu temple, also MANDIR [n -S]
MANDIRS	MANDIR, a Hindu temple, also MANDIRA [n]
MANDREL	a shaft on which a tool is mounted, also MANDRIL [n -S]
MANDRIL	a shaft on which a tool is mounted, also MANDREL [n -S]
MANEGED	MANEGE, to train horses [v]
MANEGES	MANEGE, to train horses [v]
MANGEAO	a small New Zealand tree with glossy leaves [n -S]
MANGERS	MANGER, a feeding trough for cattle [n]
MANGLER	one that mangles (to hack, tear or crush) [n -S]
MANGOES	MANGO, an edible fruit [n]
MANHOLE	an opening large enough to admit a man for service [n -S]
MANIHOT	a tropical plant [n -S]
MANIPLE	a silk band worn on the left arm as a vestment [n -S]
MANITOU	an Algonquain Indian deity, also MANITO, MANITU [n -S]
MANITUS	MANITU, an Algonquain Indian deity, also MANITOU, MANITO [n]
MANKIER	MANKY, filthy (offensively dirty) [adj]
MANNOSE	a type of sugar [n -S]
MANRENT	homage, also MANRED [n -S]
MANROPE	a rope used as a handrail [n -S]
MANTEAU	a loose cloak [n MANTEAUS or MANTEAUX]
MANTEEL	a soldiers cloak [n -S]
MANTIDS	MANTID, a predatory insect, also MANTIS [n]
MANTLED	MANTLE, to cloak (to conceal (to hide (to conceal))) [v]
MANURED	MANURE, to fertilize [v]
MANURES	MANURE, to fertilize [v]
MARCONI	to communicate by wireless telegraphy [v -ED, -ING, -S]
MARDIER	MARDY, petulant (peevish (irritable)) [adj]
MARENGO	served with a sauce of mushrooms, tomatoes, oil and wine [adj]
MAREROS	MARERO, a member of a mara in the US or Central America [n]
MARINAS	MARINA, a berthing area for boats [n]
MARINER	a sailor (a member of a ship's crew) [n -S]
MARITAL	pertaining to marriage (the legal union of a man and woman) [adj]
MARLIER	MARLY, abounding with marl [adj]
MARLINS	MARLIN, a marine game fish [n]
MARRIED	one who has entered into marriage [n -S]
MARRIES	MARRY, to enter into marriage [v]
MARTIAL	pertaining to war [adj]
MARTIAN	a supposed inhabitant of the planet Mars [n -S]
MARTING	MART, to market (to offer for sale) [v]
MARTINI	an alcoholic cocktail [n -S]
MASHIER	MASHY, of the nature of a mash [adj]
MASONED	MASON, to build with stone or brick [v]
MASTOID	the rear portion of the temporal bone [n -S]
MATELOT	a seaman (a sailor (a member of a ship's crew)) [n -S]
MATIEST	MATY, friendly (amicable (friendly)) [adj]
MATINAL	pertaining to the morning [adj]
MATRICE	the womb [n -S]
MATSURI	a Shinto festival [n -S]
MATTIES	MATTIE, a young herring [n]
MATURED	MATURE, to develop fully [v]
MATURES	MATURE, to develop fully [v]
MAULERS	MAULER, one that mauls (to batter or maltreat) [n]
MAUNDER	to talk incoherently [v -ED, -ING, -S]
MAUVEIN	a mauve dye, also MAUVEINE, MAUVIN, MAUVINE [n -S]
MAUVINE	a mauve dye, also MAUVEIN, MAUVEINE, MAUVIN [n -S]
MEAGRES	MEAGRE, a large Mediterranean food fish, also MAIGRE [n]
MEALIER	MEALY, covered with meal [adj]
MEALIES	MEALIE, an ear of corn, also MIELIE [n]
MEALING	MEAL, to cover with a grain [v]
MEANDER	to wander (to roam (to move about without purpose or plan)) [v -ED, -ING, -S]
MEANING	the sense intended [n -S]
MEASURE	to compare with a standard [v MEASURED, MEASURING, MEASURES]
MEATILY	in a meaty manner [adv]
MEDALET	a small medal [n -S]
MEDIATE	to interpose between parties as a friend to each [v MEDIATED, MEDIATING, MEDIATES]
MEDLARS	MEDLAR, an Eurasian tree [n]
MEDRESA	(Arabic) an Islamic college, or school attached to mosque [n -S]
MEDUSAN	a jellyfish, also MEDUSA, MEDUSOID [n -S]
MEERCAT	a South African carnivore, also MEERKAT [n -S]
MEERING	MEER, to bound (to leap (to spring off the ground)) [v]
MEETING	an assembly for a common purpose [n -S]
MEGARON	the principal hall in an ancient Greek house [n MEGARONS or MEGARA]
MEGATON	a unit of explosive force [n -S]
MEINIES	MEINIE, a retinue, also MEINEY, MEINY, MENYIE [n]
MEIOTIC	pertaining to meiosis (a type of cell division) [adj]
MELANGE	a mixture (the product of mixing) [n -S]
MELANIC	one who is affected with melanism, also MELANIST [n -S]
MELANIN	a dark pigment [n -S]
MELENAS	MELENA, a condition marked by black tarry stool [n]
MELODIA	a type of organ stop [n -S]
MELTAGE	the process of melting [n -S]
MELTIER	MELTY, liable to melt [adj]
MELTING	the act of melting [n -S]
MELTONS	MELTON, a heavy woollen fabric [n]
MENACER	one that menaces (to threaten (to intimidate, also THREAT)) [n -S]
MENAGED	MENAGE, to manage (to control or direct) [v]
MENAGES	MENAGE, to manage (to control or direct) [v]
MENDIGO	a freshwater fish [n -S]
MENORAH	a candleholder used in Jewish worship [n -S]
MENSUAL	monthly [adj]
MENTION	to remark briefly [v -ED, -ING, -S]
MEOUING	MEOU, to make the sound of a crying cat, also MEOW, MIAOU, MIAOW, MIAUL [v]
MERITED	MERIT, to earn (to obtain reward for labour) [v]
MERLING	the whiting (ground chalk) [n -S]
MERLONS	MERLON, the part of a parapet between embrasures [n]
MEROPIA	partial blindness [n -S]
MESONIC	resembling a meson (a subatomic particle, also MESOTRON) [adj]
METAGES	METAGE, an official weighing of coal, grain etc [n]
METALED	METAL, to provide with any ductile, fusible or lustrous substances [v]
METAYER	a tenant farmer who uses metayage [n -S]
METHANE	a flammable gas [n -S]
METICAL	a monetary unit of Mozambique [n METICALS or METICAIS]
METOPAE	METOPE, a space between two triglyphs [n]
METRING	METRE, to measure of mechanical means, also METER [v]
MIAOUED	MIAOU, to make the sound of a crying cat, also MEOW, MEOU, MIAOW, MIAUL [v]
MIAOWED	MIAOW, to make the sound of a crying cat, also MEOW, MEOU, MIAOU, MIAUL [v]
MIAULED	MIAUL, to make the sound of a crying cat, also MEOW, MEOU, MIAOU, MIAOW [v]
MICATED	MICATE, to furnish with mica [v]
MICATES	MICATE, to furnish with mica [v]
MIDYEAR	in the middle of the year [n -S]
MIGRANT	one who migrates, also MIGRATOR [n -S]
MIGRATE	to move from one region to another [v MIGRATED, MIGRATING, MIGRATES]
MILAGES	MILAGE, the total distance expressed in miles, also MILEAGE [n]
MILDENS	MILDEN, to become mild (gentle in temper and disposition) [v]
MILDEST	MILD, gentle in temper and disposition [adj]
MILEAGE	the total distance expressed in miles, also MILAGE [n -S]
MILITAR	military [adj]
MILTIER	MILTY, full of milt [adj]
MINABLE	able to be mined [adj]
MINETTE	an intrusive rock [n -S]
MINEVER	a fur coat [n -S]
MINGIER	MINGY, mean and stingy [adj]
MINGLER	one who mingles (to mix together) [n -S]
MINORCA	any of a breed of large domestic fowls [n -S]
MINORED	MINOR, to study a subsidiary subject at college [v]
MINUETS	MINUET, a slow, stately dance [n]
MINUTED	MINUTE, to take brief notes [v]
MINUTES	MINUTE, to take brief notes [v]
MINUTIA	a small detail [n MINUTIAE]
MIOCENE	denoting the fourth epoch of the Tertiary period [adj]
MIRABLE	wonderful [adj]
MIRACLE	an act which breaks the law of nature [n -S]
MIRAGES	MIRAGE, a type of optical illusion [n]
MIRBANE	a name for nitrobenzene [n -S]
MIRIEST	MIRY, swampy (marshy (resembling a marsh (a tract of low, wet land, also MARISH))) [adj]
MISAVER	to speak erroneously [v MISAVERRED, MISAVERRING, MISAVERS]
MISDONE	MISDO, to do wrongly [v]
MISFARE	to fare badly [v MISFARED, MISFARING, MISFARES]
MISHEAR	to hear incorrectly [v MISHEARD, MISHEARING, MISHEARS]
MISRULE	to rule unwisely or unjustly [v MISRULED, MISRULING, MISRULES]
MISTIER	MISTY, blurry (unclear (not clear)) [adj]
MISTLED	MISTLE, to rain in small drops [v]
MISTRAL	a cold dry wind [n -S]
MISTUNE	to tune incorrectly [v MISTUNED, MISTUNING, MISTUNES]
MITERED	MITER, to raise to the rank of a bishop, also MITRE [v]
MITERER	one that miters (to raise to the rank of a bishop, also MITRE) [n -S]
MITOGEN	a substance the induces mitosis [n -S]
MOATING	MOAT, to surround with a water-filled trench [v]
MODELER	one that models, also MODELLER [n -S]
MODENAS	MODENA, a shade of crimson [n]
MODERNE	pretentiously modern [adj MODERNER, MODERNEST] / a design style of the 1920s and 1930s [n -S]
MOERING	MOER, to attack (South African slang) [v]
MOIDORE	a former gold coin of Portugal [n -S]
MOINEAU	a small flat bastion [n -S]
MOITHER	to confuse (to perplex (to puzzle (to perplex))) [v -ED, -ING, -S]
MOLDIER	MOLDY, musty (having a stale odour) [adj]
MONADES	MONAS, a monad (a single-celled organism) [n]
MONDIAL	worldwide [adj]
MONERAN	a cellular organism that does not have a distinct nucleus [n -S]
MONGERS	MONGER, to peddle (to sell or offer for sale) [v]
MONGREL	a plant or animal of mixed breed [n -S]
MONIALS	MONIAL, a mullion, the upright division between the panes of a window [n]
MONIKER	a name, also MONICKER [n -S]
MONILIA	a fungus (any of the major group of lower plants) [n -S]
MONITOR	to keep track of [v -ED, -ING, -S]
MONTAGE	to combine into a composite picture [v MONTAGED, MONTAGING, MONTAGES]
MONTANE	the lower vegetation belt of a mountain [n -S]
MONTERO	a type of cap [n -S]
MONTURE	a mounting (a backing for something else) [n -S]
MOODIER	MOODY, given to changing attitudes [adj]
MOODIES	MOODY, to persuade by flattery [v]
MOOLIES	MOOLY, a hornless cow, also MULEY, MOOLEY, MULLEY [n]
MOONERS	MOONER, one who moons (to wander about listlessly) [n]
MOONIER	MOONY, resembling the moon [adj]
MOONIES	MOONY, a noodle [n]
MOONLET	a small satellite [n -S]
MOONSET	the time when the moon disappears [n -S]
MOORAGE	the act of mooring [n -S]
MOOTERS	MOOTER, one who moots (to bring up for discussion) [n]
MOPANES	MOPANE, a small South African tree, also MOPANI [n]
MOPIEST	MOPY, dejected, also MOPEY [adj]
MORAINE	an accumulation of debris deposited by a glacier [n -S]
MORCEAU	a short literary or musical composition [n MORCEAUX]
MORDANT	to treat with a caustic substance [v -ED, -ING, -S]
MORDENT	a melodic embellishment [n -S]
MOREENS	MOREEN, a heavy fabric [n]
MOREISH	such that one wants more [adj]
MORENDO	dying away in speed and tone [adj]
MORGENS	MORGEN, a Dutch unit of land area [n]
MORTICE	to join or fasten securely, also MORTISE [v MORTICED, MORTICING, MORTICES]
MORULAE	MORULA, an embryonic mass of cells [n]
MOTHIER	MOTHY, full of moths [adj]
MOTIEST	MOTEY, full of motes [adj]
MOTIVED	MOTIVE, to inspire to action, also MOTIVATE [v]
MOTIVES	MOTIVE, to inspire to action, also MOTIVATE [v]
MOTLIER	MOTLEY, variegated [adj]
MOTORED	MOTOR, to travel by automobile [v]
MOTTIER	MOTTY, containing motes [adj]
MOTTIES	MOTTY, (Irish) a target at which coins are aimed in pitch-and-toss [n]
MOULAGE	the making of a cast for a criminal investigation [n -S]
MOULTEN	having moulted [adj]
MOULTER	one that molts, also MOLTER [n -S]
MOUNTED	MOUNT, to climb (to ascend (to rise (to move upward))) [v]
MOUNTER	one that mounts (to climb (to ascend)) [n -S]
MOURNED	MOURN, to grieve (to feel grief, also GREAVE) [v]
MOUSIER	MOUSY, resembling a mouse, also MOUSEY [adj]
MOUTERS	MOUTER, to take a fee for grinding grain [v]
MUISTED	MUIST, to powder (to reduce to fine dust-like particles) [v]
MULETAS	MULETA, a red cloth used by a matador [n]
MUNITED	MUNITE, to fortify, also MUNIFY [v]
MUNITES	MUNITE, to fortify, also MUNIFY [v]
MURAENA	a food fish of the Romans, also MURENA [n -S]
MURALED	decorated with a mural, also MURALLED [adj]
MUREINS	MUREIN, a type of polymer (a complex chemical compound) [n]
MURENAS	MURENA, a food fish of the Romans, also MURAENA [n]
MURGEON	to mock with grimaces [v -ED, -ING, -S]
MURIATE	chloride (a chlorine compound, also CHLORID) [n -S]
MURINES	MURINE, any of the family of small rodents, also MURID [n]
MURLAIN	a basket, also MURLAN, MURLIN [n -S]
MUSTIER	MUSTY, having a stale odour [adj]
MUTAGEN	a substance that causes biological mutation [n -S]
MUTINED	MUTINE, to revolt against constituted authority, also MUTINY, MUTINEER [v]
MUTINES	MUTINE, to revolt against constituted authority, also MUTINY, MUTINEER [v]
NAARTJE	a small sweet orange, also NARTJIE [n -S]
NAEBODY	nobody (an unimportant person) [n NAEBODIES]
NAEVOID	pertaining to naevus (a birthmark) [adj]
NAGAPIE	a nocturnal lemur [n -S]
NAIVELY	in a naive manner, also NAIFLY [adv]
NAIVETY	the quality of being naive, also NAIVETE [n NAIVETIES]
NAIVIST	in a naive style [adj]
NAKEDER	NAKED, without clothes [adj]
NAMASTE	an Indian form of greeting, also NAMASKAR [n -S]
NAMETAG	a tag bearing one's name [n -S]
NANCIES	NANCY, an effeminate young man, also NANCE [n]
NANOBES	NANOBE, a very small microbe [n]
NAPOOED	NAPOO, to kill (to put to death) [v]
NARCEEN	a narcotic component of opium, also NARCEINE, NARCEIN [n -S]
NARCEIN	a narcotic component of opium, also NARCEINE, NARCEEN [n -S]
NARKIER	NARKY, irritable [adj]
NASTILY	in a nasty manner [adv]
NATHEMO	never the more [adv]
NATRIUM	sodium (a metallic element) [n -S]
NATTERY	peevish (irritable) [adj]
NAUTICS	water sports [n]
NAVETTE	a gem cut in a pointed oval form [n -S]
NEAPING	NEAP, to tend towards the tide of the smallest range [v]
NEATNIK	a compulsively neat person [n -S]
NEBULAE	NEBULA, a cloud-like interstellar mass [n]
NEBULAR	relating to nebulae [adj]
NEBULAS	NEBULA, a cloud-like interstellar mass [n]
NECROSE	to affect with necrosis [v NECROSED, NECROSING, NECROSES]
NECTARY	a plant gland [n NECTARIES]
NEDDIER	NEDDY, like a ned, a hooligan [adj]
NEEDILY	in a needy manner [adv]
NEIGHED	NEIGH, to utter the cry of a horse [v]
NEMORAL	of a wood [adj]
NEOTENY	attainment of sexual maturity in the larval stage [n NEOTENIES]
NEPOTIC	pertaining to nepotism (favouritism shown to a relative) [adj]
NERVIER	NERVY, nervous (easily excited) [adj]
NERVINE	a soothing medicine [n -S]
NERVOUS	easily excited [adj]
NETHEAD	an enthusiast or expert on the internet [n -S]
NETLIKE	like a net [adj]
NEURISM	a hypothetical nerve force [n -S]
NEUROMA	a type of tumor (an abnormal swelling) [n NEUROMAS or NEUROMATA]
NEURULA	a vertebrate embryo [n NEURULAS or NEURULAE]
NEUSTIC	relating to neustons [adj]
NICOISE	made or garnished with tomatoes and olive oil, literally from Nice [adj]
NICTATE	to wink NICTATED [v NICTATED, NICTATING, NICTATES]
NIGELLA	a type of plant [n -S]
NIGHEST	NIGH, near (situated within a short distance) [adj]
NIGHTED	benighted, lost in darkness [adj]
NIGHTIE	a nightgown, also NIGHTY [n -S]
NIOBITE	a mineral [n -S]
NIVEOUS	resembling snow [adj]
NOBLEST	NOBLE, possessing qualities of excellence [adj]
NOCTULE	a large bat [n -S]
NODATED	knotted [adj]
NODDIER	NODDY, easy to understand [adj]
NODDIES	NODDY, a fool [n]
NODICAL	pertaining to an astronomical point [adj]
NOISOME	harmful to health [adj]
NOMADES	NOMADE, a wanderer, also NOMAD [n]
NOMINEE	one that is nominated [n -S]
NONLIFE	the absence of life [n NONLIVES]
NONMEAT	not containing meat [adj]
NOOKIER	NOOKY, resembling a nook (a corner) [adj]
NOOKIES	NOOKIE, sexual intercourse [n]
NOPLACE	not at any place, nowhere [adv]
NORITIC	pertaining to norite (a granular rock) [adj]
NORTHED	NORTH, to head northwards [v]
NORTHER	to veer north [v -ED, -ING, -S]
NOSEBAG	a feedbag (a nosebag for feeding horses) [n -S]
NOSEGAY	a bouquet (a bunch of flowers) [n -S]
NOTABLE	a person of distinction [n -S]
NOTAEUM	the upper surface of a bird's trunk [n -S]
NOTCHER	one that notches (to make an angular cut in) [n -S]
NOTEDLY	in a famous manner [adv]
NOTEPAD	sheets of paper glued together at one end [n -S]
NOTICED	NOTICE, to become aware of [v]
NOUMENA	NOUMENON, an object of intellectual intuition [n]
NOURICE	a nurse [n -S]
NOVALIA	newly reclaimed wastelands [n]
NOVATED	NOVATE, to substitute a new obligation for an existing one [v]
NOVENAE	NOVENA, a religious devotion lasting nine days [n]
NOVENAS	NOVENA, a religious devotion lasting nine days [n]
NOVICES	NOVICE, a beginner (a novice) [n]
NOYADES	NOYADE, an execution by drowning [n]
NUCLEAR	pertaining to a nucleus (an essential part of a cell) [adj]
NUCLIDE	a species of atom, also NUCLEIDE [n -S]
NUMERAL	a symbol that expresses a number [n -S]
NUPTIAL	a wedding (a marriage ceremony) [n -S]
NURAGHE	an ancient round tower, also NURHAG [n NURAGHI]
NUTCASE	a crazy person [n -S]
NUTMEAL	meal made from nuts [n -S]
OARLIKE	like an oar [adj]
OARWEED	a type of seaweed (a plant growing in the sea) [n -S]
OATLIKE	like an oat [adj]
OATMEAL	meal made from oats [n -S]
OBELION	a part of the skull [n OBELIA]
OBELISE	to mark with an obelus, also OBELIZE [v OBELISED, OBELISING, OBELISES]
OBENTOS	OBENTO, a Japanese meal packed in a box, also BENTO [n]
OBESITY	the condition of being obese [n OBESITIES]
OBITUAL	pertaining to obits (a date of death) [adj]
OBLIGED	OBLIGE, to bind by some favour rendered [v]
OBLIGEE	one who is obliged [n -S]
OBLIGER	one who obliges (to bind by some favour rendered) [n -S]
OBLIGES	OBLIGE, to bind by some favour rendered [v]
OBTENDS	OBTEND, to allege (to assert without proof) [v]
OBTRUDE	to thrust forward [v OBTRUDED, OBTRUDING, OBTRUDES]
OBTUSER	OBTUSE, dull (mentally slow) [adj]
OBVIATE	to forestall [v OBVIATED, OBVIATING, OBVIATES]
OCARINA	a wind instrument [n -S]
OCEANID	an ocean nymph [n OCEANIDS or OCEANIDES]
OCELOID	pertaining to an ocelot (an American wildcat) [adj]
OCHREAE	OCHREA, a sheathing plant part, also OCREA [n]
OCREATE	relating to an ocrea, also OCHREATE [adj]
OCTAVES	OCTAVE, a type of musical interval [n]
OCULATE	having eyes [adj]
ODALLER	a holder of an odal estate, also UDALLER [n -S]
ODORIZE	to make odorous, also ODORISE [v ODORIZED, ODORIZING, ODORIZES]
OEDEMAS	OEDEMA, edema (an excessive accumulation of serous fluid) [n]
OEDIPAL	pertaining to a child's sexual feeling to a parent, also OEDIPEAN [adj]
OESTRUM	the period of heat in female mammals, also ESTRUM, ESTRUS, OESTRUS [n -S]
OEUVRES	OEUVRE, a work of art [n]
OFTENER	OFTEN, frequently [adv]
OGREISH	resembling an ogre, also OGRISH [adj]
OGREISM	the state of being ogreish, also OGRISM [n -S]
OILCANS	OILCAN, a can containing oil [n]
OINOMEL	an ancient Greek beverage, also OENOMEL [n -S]
OLEFINE	an alkene, also OLEFIN [n -S]
OLIVINE	a mineral [n -S]
OMELETS	OMELET, a dish made with beaten eggs, also OMELETTE [n]
OMENTAL	relating to a omentum [adj]
OMITTED	OMIT, to leave out [v]
OMITTER	one that omits (to leave out) [n -S]
OMNEITY	allness, also OMNIETY [n OMNEITIES]
OMNIETY	allness, also OMNEITY [n OMNIETIES]
ONEIRIC	belonging to dreams, also ONIRIC [adj]
ONESELF	a person's self [pron]
ONETIME	former [adj]
ONEYERS	ONEYER, one, also ONEYRE [n]
ONEYRES	ONEYRE, one, also ONEYER [n]
ONSHORE	towards the shore [adv]
OOFIEST	OOFY, expensive, ostentatious [adj]
OOZIEST	OOZY, slimy (resembling slime) [adj]
OPENERS	OPENER, one that opens (to expose to view) [n]
OPENEST	OPEN, not shut [adj]
OPERAND	something on which an operation is performed [n -S]
OPERANT	one that operates (to perform a function) [n -S]
OPERATE	to perform a function [v OPERATED, OPERATING, OPERATES]
OPERONS	OPERON, a type of gene cluster [n]
OPHITES	OPHITE, an igneous rock [n]
OPIATED	OPIATE, to treat with opium [v]
OPTIMES	OPTIME, an honour student in mathematics at Cambridge University [n]
OPULENT	wealth, also OPULENCE, OPULENCY [n pl.]
OPUNTIA	an American cactus [n -S]
ORACHES	ORACHE, a cultivated plant, also ORACH [n]
ORACLED	ORACLE, to utter as an oracle [v]
ORALISM	the use of the oral method for teaching the deaf [n -S]
ORALITY	the state of being produced orally [n ORALITIES]
ORANGEY	resembling the colour of an orange, also ORANGY [adj]
ORBITAL	a subdivision of a nuclear shell [n -S]
ORBITAS	ORBITA, the hollow in which the eyeball rests [n]
ORBITED	ORBIT, to revolve around [v]
ORBITER	one that orbits (to revolve around) [n -S]
ORGANIC	a substance of animal or vegetable origin [n -S]
ORIENCY	a quality of the orient [n ORIENCIES]
ORIFICE	a mouth-like opening, also ORIFEX [n -S]
ORIGAMI	the Japanese art of paper folding [n -S]
OROPESA	a float used in minesweeping [n -S]
ORRAMEN	ORRAMAN, (Scots) an odd job man [n]
ORRICES	ORRICE, a flowering plant, also ORRIS [n]
ORTHIAN	high-pitched [adj]
OSTEOMA	a tumor of bone tissue [n OSTEOMAS or OSTEOMATA]
OSTIARY	a doorkeeper at a church [n OSTIARIES]
OTALGIC	pertaining to otalgia (pain in the ear, also OTALGY) [adj]
OUABAIN	a cardiac stimulant [n -S]
OUREBIS	OUREBI, an African antelope, also ORIBI [n]
OUTBEAM	to surpass in beaming [v -ED, -ING, -S]
OUTBRED	OUTBREED, to interbreed relatively unrelated stocks [v]
OUTDREW	OUTDRAW, to attract a larger audience than [v]
OUTFACE	to confront unflinchingly [v OUTFACED, OUTFACING, OUTFACES]
OUTFEEL	to surpass in feeling [v OUTFELT, OUTFEELING, OUTFEELS]
OUTFIRE	to surpass in firing [v OUTFIRED, OUTFIRING, OUTFIRES]
OUTGAVE	OUTGIVE, to give more than [v]
OUTGIVE	to give more than [v OUTGAVE, OUTGIVEN, OUTGIVING, OUTGIVES]
OUTGREW	OUTGROW, to grow too large for [v]
OUTHEAR	to surpass in hearing [v OUTHEARD, OUTHEARING, OUTHEARS]
OUTHIRE	to give out as if on hire [v OUTHIRED, OUTHIRING, OUTHIRES]
OUTLEAP	to surpass in leaping (to spring off the ground) [v OUTLEAPED, OUTLEAPT, OUTLEAPING, OUTLEAPS]
OUTLIVE	to live longer than [v OUTLIVED, OUTLIVING, OUTLIVES]
OUTNAME	to surpass in notoriety [v OUTNAMED, OUTNAMING, OUTNAMES]
OUTPACE	to surpass in speed (to move swiftly) [v OUTPACED, OUTPACING, OUTPACES]
OUTPEER	to surpass (to go beyond) [v -ED, -ING, -S]
OUTRACE	to run faster than [v OUTRACED, OUTRACING, OUTRACES]
OUTRAVE	to surpass in raving [v OUTRAVED, OUTRAVING, OUTRAVES]
OUTROPE	an auction sale, also OUTROOP [n -S]
OUTSIZE	an exceptionally large size [n -S]
OUTVIED	OUTVIE, to surpass in competition [v]
OUTVIES	OUTVIE, to surpass in competition [v]
OUTWEAR	to last longer than [v OUTWORE, OUTWORN, OUTWEARING, OUTWEARS]
OUTWEED	to root out [v -ED, -ING, -S]
OUTWILE	to surpass in wiling (to entice (to lead astray)) [v OUTWILED, OUTWILING, OUTWILES]
OUTWORE	OUTWEAR, to last longer than [v]
OUVERTE	open (not shut) [adj]
OUVRAGE	work [n -S]
OUVRIER	a worker (one who works (to toil in mind or body)) [n -S]
OVARIAL	pertaining to an ovary, also OVARIAN [adj]
OVARIAN	pertaining to an ovary, also OVARIAL [adj]
OVATELY	in an ovate manner [adv]
OVATING	OVATE, to receive with an ovation [v]
OVATION	a demonstration of popular acclaim [n -S]
OVERACT	to act with exaggeration [v -ED, -ING, -S]
OVERAGE	an amount in excess [n -S]
OVERAPT	excessively apt [adj]
OVERATE	OVEREAT, to eat to excess [v]
OVERAWE	to subdue by inspiring awe [v OVERAWED, OVERAWING, OVERAWES]
OVERBID	to bid higher than [v OVERBIDDING, -S]
OVERDUE	not paid when due [adj]
OVEREAT	to eat to excess [v OVERATE or OVEREAT, OVEREATEN, OVEREATING, OVEREATS]
OVERFAT	too fat (having an abundance of flesh) [adj]
OVERFIT	too fit, the opposite of underfit [adj]
OVERGET	to overcome (to get the better of) [v OVERGOT, OVERGETTING, OVERGETS]
OVERHIT	to hit a ball beyond a target [v OVERHIT, OVERHITTING, OVERHITS]
OVERING	OVER, to leap above [v]
OVERLAP	to extend over and cover [v OVERLAPPED, OVERLAPPING, OVERLAPS]
OVERLAY	to lay over [v OVERLAID, OVERLAIN, OVERLAYING, OVERLAYS]
OVERLET	to let to excess [v OVERLETTING, -S]
OVERLIE	to lie over [v -S]
OVERLIT	OVERLIGHT, to light too much [v]
OVERMAN	to provide with more men than needed [v OVERMANNED, OVERMANNING, OVERMANS] / a foreman (a man who supervises workers) [n OVERMEN]
OVERNET	to cover with a net [v OVERNETTED, OVERNETTING, OVERNETS]
OVERRAN	OVERRUN, to swarm over [v]
OVERREN	to overrun (to swarm over) [v OVERRENNING, -S]
OVERSAW	OVERSEE, to watch over and direct [v]
OVERTAX	to tax too heavily [v -ED, -ING, -ES]
OVERTIP	to tip more than is normal [v OVERTIPPED, OVERTIPPING, OVERTIPS]
OVERUSE	to use too much [v OVERUSED, OVERUSING, OVERUSES]
OVULATE	to produce ova [v OVULATED, OVULATING, OVULATES]
OWNABLE	able to be owned [adj]
OWRELAY	a large cravat (a necktie (a strip of fabric worn around the neck)) [n -S]
OXALATE	to treat with a chemical salt [v OXALATED, OXALATING, OXALATES]
OXHEART	a variety of sweet cherry [n -S]
OXIDANT	an oxidizing agent [n -S]
OXIDASE	an oxidizing enzyme [n -S]
OXIDATE	to oxidize (to combine with oxygen, also OXIDISE) [v OXIDATED, OXIDATING, OXIDATES]
OXTERED	OXTER, to take under the arm [v]
OZAENAS	OZAENA, a fetid discharge from the nostrils [n]
OZONATE	to treat with ozone [v OZONATED, OZONATING, OZONATES]
OZONIDE	a compound of ozone [n -S]
OZONISE	to convert into ozone, also OZONIZE [v OZONISED, OZONISING, OZONISES]
PACIEST	PACY, fast, also PACEY [adj]
PACTION	to agree (to have the same opinion) [v -ED, -ING, -S]
PADRONE	a master [n PADRONES or PADRONI]
PADRONI	PADRONE, a master [n]
PAEONIC	a rhythm pattern in verse, also PAEON [n -S]
PAESANI	PAESANO, a fellow countryman, also PAESAN [n]
PAESANO	a fellow countryman, also PAESAN [n PAESANOS or PAESANI]
PAGEANT	an elaborate public spectacle [n -S]
PAIGLES	PAIGLE, the cowslip, also PAGLE [n]
PAISANO	a fellow countryman, also PAISAN [n -S]
PALEATE	like a palea [adj]
PALETOT	a loose overcoat [n -S]
PALMIER	PALMY, marked by prosperity, also PALMIE [adj]
PALMIET	a riverside plant [n -S]
PANDITS	PANDIT, an Indian wise man [n]
PANDORE	ancient musical instrument, also BANDORA, BANDORE, PANDORA, PANDURA [n -S]
PANEITY	the state of being bread [n PANEITIES]
PANELED	PANEL, to decorate with thin sheets of material [v]
PANICLE	a loosely branched flower cluster [n -S]
PANNIER	a large basket, also PANIER [n -S]
PANNOSE	like felt [adj]
PANTHER	a leopard (a large, carnivorous, feline mammal) [n -S]
PANTINE	a pasteboard doll with movable limbs [n -S]
PANTLER	an officer in charge of provisions, also PANTER [n -S]
PAREIRA	a medicinal plant root [n -S]
PARETIC	one affected with paresis [n -S]
PARIANS	PARIAN, a hard, white porcelain [n]
PARITOR	an officer of the court [n -S]
PARODOI	PARODOS, an ode sung in ancient Greek drama [n]
PAROLED	PAROLE, to give a conditional release of a prisoner [v]
PAROLEE	one who is paroled [n -S]
PARORES	PARORE, a type of fish found around New Zealand and Australia [n]
PAROTIC	situated near the ear [adj]
PAROTID	a salivary gland in front of the ear, also PAROTIS [n -S]
PAROTIS	inflammation of the parotid gland [n PAROTIDES]
PARRIED	PARRY, to ward off a blow [v]
PARTIAL	as in partial out, to eliminate a factor in statistics [v PARTIALLED, PARTIALLING, PARTIALS]
PARTIER	one who parties, also PARTYER [n -S]
PARTING	a division or separation [n -S]
PARTNER	to join with in a common interest [v -ED, -ING, -S]
PASTIME	a recreational activity [n -S]
PASTINA	a type of macaroni (a tubular pasta, also MACCARONI) [n -S]
PASTURE	to put out to graze [v PASTURED, PASTURING, PASTURES]
PATERAE	PATERA, a type of Roman shallow dish [n]
PATIBLE	capable of suffering [adj]
PATIENT	to make calm and uncomplaining [v -ED, -ING, -S] / calm and uncomplaining [adj PATIENTER, PATIENTEST]
PATINAE	PATINA, a sheen acquired through time [n]
PATINAS	PATINA, a sheen acquired through time [n]
PATONCE	describing a type of heraldic cross [adj]
PATRIAL	one who is entitled to stay in the UK because of a British parent [n -S]
PATRICO	a hedge-priest [n -ES]
PATRIOT	one who loves his country [n -S]
PATROON	a landowner granted manorial rights under old Dutch law [n -S]
PATTERN	to copy a design [v -ED, -ING, -S]
PATTIES	PATTY, a small, flat cake of chopped food, also PATTIE [n]
PATULIN	a drug [n -S]
PAVONES	PAVONE, a peacock [n]
PEACOAT	a heavy woollen jacket [n -S]
PEALING	PEAL, to ring out [v]
PEANING	PEAN, to beat with a rounded hammer head, also PEEN, PEIN, PENE [v]
PEANUTS	PEANUT, the monkey-nut or groundnut [n]
PEARLED	PEARL, to adorn with a milky-white concretion of nacre [v]
PEARTER	PEART, lively (full of energy) [adj]
PEASANT	a person of inferior social rank [n -S]
PEATERY	a region covered with peat, also PEATARY, PETARY [n PEATERIES]
PEATMEN	PEATMAN, a peat seller [n]
PEAVIES	PEAVY, a lever used to move logs, also PEAVEY [n]
PEBRINE	a silkworm disease [n -S]
PEDALER	someone who uses pedals, also PEDALLER [n -S]
PEDALOS	PEDALO, a type of pleasure boat powered by pedalling [n]
PEDLARS	PEDLAR, one who peddles, also PEDDLER, PEDLER [n]
PEELING	a piece or strip that has been peeled off [n -S]
PEERING	PEER, to look narrowly or searchingly [v]
PELICAN	a large, web-footed bird [n -S]
PELORIA	unexpected regularity in a flower, also PELORISM, PELORY [n -S]
PELORIC	pertaining to a peloria (unexpected regularity in a flower, also PELORISM, PELORY) [adj]
PELOTON	the main body of riders in a bicycle race [n -S]
PELTING	the act of pelting [n -S]
PENLITE	a small torch, also PENLIGHT [n -S]
PENNATE	having wings or feathers, also PENNATED [adj]
PENSILE	hanging loosely [adj]
PENSION	to grant a retirement allowance to [v -ED, -ING, -S]
PENTANE	a volatile liquid [n -S]
PENTHIA	a bitter plant [n -S]
PENTICE	to provide with a penthouse, also PENTISE [v PENTICED, PENTICING, PENTICES]
PENTITO	in Italy, a Mafia criminal who has become a police informer [n PENTITI]
PENTODE	a type of electron tube [n -S]
PENTOSE	a sugar with five carbon atoms per molecule [n -S]
PEONAGE	the condition of being a peon, also PEONISM [n -S]
PEONIES	PEONY, a showy flower, also PAEONY, PINY, PIONEY, PIONY [n]
PEONISM	the condition of being a peon, also PEONAGE [n -S]
PERACID	a type of acid (a type of chemical compound) [n -S]
PERAEON	a crustacean's thorax, also PEREION, PEREON [n PERAEONS or PERAEA]
PERCINE	pertaining to fish of the perch family [adj]
PERCOID	a spiny-finned fish [n -S]
PEREGAL	an equal [n -S]
PEREION	a crustacean's thorax, also PERAEON, PEREON [n PEREIONS or PEREIA]
PEREIRA	a type of Brazilian tree [n -S]
PEREONS	PEREON, a crustacean's thorax, also PEREION, PERAEON [n]
PERGOLA	a shaded shelter or passageway [n -S]
PERICON	a type of folk dance [n PERICONES]
PERIDIA	PERIDIUM, the outer coating of the spore carrier of a fungus [n]
PERIDOT	a green mineral, also PERIDOTE [n -S]
PERIGON	an angle equal to 360 degrees [n -S]
PERILED	PERIL, to put in danger, also IMPERIL [v]
PERINEA	PERINEUM, the region between genitals and anus [n]
PERITUS	a type of theological expert [n PERITI]
PERLITE	a volcanic glass [n -S]
PERMIAN	relating to the last period of the Palaeozoic era [adj]
PERONES	PERONE, the fibula (a bone in the leg) [n]
PERORAL	occurring through the mouth [adj]
PERSICO	a cordial, also PERSICOT [n -S]
PERUSAL	the act of perusing (to read (to look at and understand written matter)) [n -S]
PESAUNT	a peasant, also PESANT, PEZANT [n -S]
PETALED	having petals (a leaflike part of a corolla) [adj]
PETARAS	PETARA, a type of clothes basket, also PITARA, PITARAH [n]
PETIOLE	the stalk of a leaf [n -S]
PETRALE	a type of sole fish [n -S]
PETROUS	resembling stone in hardness [adj]
PETTIER	PETTY, insignificant [adj]
PETUNIA	a tropical herb [n -S]
PHAETON	a light carriage [n -S]
PHENATE	a salt of carbolic acid [n -S]
PHONATE	to produce speech sounds [v PHONATED, PHONATING, PHONATES]
PHONIED	PHONY, to alter, so as to appear genuine [v]
PHONIER	PHONY, not genuine or real, also PHONEY [adj]
PHONIES	PHONY, to alter, so as to appear genuine [v]
PHORATE	an insecticide [n -S]
PIANIST	someone who plays the piano, also PIANISTE [n -S]
PIARIST	a member of a Christian group who educate the poor [n -S]
PICANTE	hot and spicy [adj]
PICOTED	PICOT, to edge with ornamental loops [v]
PICOTEE	a variety of carnation [n -S]
PICRATE	a chemical salt [n -S]
PIDGEON	a type of business affair [n -S]
PIEFORT	an unusually thick coin, also PIEDFORT [n -S]
PIERAGE	a pier toll [n -S]
PIEROGI	a small dumpling with a filling, also PIROGI [n PIEROGIES]
PIERROT	a clown [n -S]
PIETIES	PIETY, the state of being pious, also PIETISM [n]
PIGNORA	PIGNUS, property held as security for a debt [n]
PILEATE	having a pileus, also PILEATED [adj]
PILEOUS	covered with hair, also PILOSE, PILOUS [adj]
PILOTED	PILOT, to control the course of [v]
PIMENTO	a sweet pepper, also PIMIENTO [n -S]
PINATAS	PINATA, a pottery jar used in a Mexican game [n]
PINCASE	a holder for pins [n -S]
PINDARI	an Indian mercenary, also PINDAREE [n -S]
PINGLER	one that pingles (to strive (to contend)) [n -S]
PINHEAD	the head of a pin [n -S]
PINHOLE	a small hole made by a pin [n -S]
PINNATE	resembling a feather, also PINNATED [adj]
PINNOED	PINION, to remove the wing feathers to prevent flight [v]
PINOCLE	a card game, also PINOCHLE, PENUCHLE, PENUCKLE [n -S]
PINONES	PINON, a pine tree, also PINYON [n]
PINTADA	a large food fish, also PINTADO [n -S]
PINTADO	a large food fish, also PINTADA [n PINTADOS or PINTADOES]
PINTAIL	a river duck [n -S]
PINTANO	a tropical fish [n -S]
PINWALE	a type of fabric [n -S]
PIONEER	to be first in a new field of enterprise [v -ED, -ING, -S]
PIONEYS	PIONEY, a showy flower, also PEONY, PAEONY, PINY, PIONY [n]
PIONIES	PIONY, a showy flower, also PEONY, PAEONY, PINY, PIONEY [n]
PIRANAS	PIRANA, a ferocious, carnivorous South American fish, also PIRANHA, PERAI, PIRAI, PIRAYA [n]
PIRNIES	PIRNIE, a striped woollen nightcap [n]
PIROGEN	PIROG, a large Russian pastry [n]
PIROGUE	a dugout canoe, also PIRAGUA, PIROQUE [n -S]
PITARAS	PITARA, a type of clothes basket, also PETARA, PITARAH [n]
PITEOUS	arousing pity, also PITIFUL [adj]
PITHEAD	a mine entrance [n -S]
PITIERS	PITIER, one who pities (to feel sorrow at another's misfortune) [n]
PIVOTED	PIVOT, to turn on a shaft or rod [v]
PIVOTER	someone who makes pivots [n -S]
PLAINED	PLAIN, to complain (to express discontent) [v]
PLAINTS	PLAINT, a complaint [n]
PLAITED	PLAIT, to braid (to plait) [v]
PLANATE	having a flat surface [adj]
PLANTAE	PLANTA, the sole of the foot [n]
PLANTED	PLANT, to place in the ground for growing [v]
PLANTER	one who plants (to place in the ground for growing) [n -S]
PLATANE	a large tree, also PLATAN [n -S]
PLATINA	a metallic element, also PLATINUM [n -S]
PLEADER	one who pleads (to beg for earnestly) [n -S]
PLEAING	PLEA, to dispute in a court [v]
PLEATED	PLEAT, to fold in an even manner [v]
PLEATER	one that pleats (to fold in an even manner) [n -S]
PLEONIC	relating to the pleon, also PLEONAL [adj]
PLEROMA	fullness (the state of being full, also FULNESS) [n -S]
PLEURAE	PLEURA, a membrane that covers the lungs [n]
PLEURAS	PLEURA, a membrane that covers the lungs [n]
PLEURON	a part of a thoracic segment of an insect [n PLEURA]
PLICATE	to pleat (to fold in an even manner) [v PLICATED, PLICATING, PLICATES]
PLOATED	PLOAT, to scald (to burn with hot liquid or steam) [v]
PLOTTIE	a spiced hot drink, also PLOTTY [n -S]
PLOUTER	to potter, also PLOTTER, PLOWTER [v -ED, -ING, -S]
PODGIER	PODGY, short and fat, also PUDGY, PUDSEY, PUDSY [adj]
POESIED	POESY, to utter poetry [v]
POETICS	poetic theory or practise [n]
POETISE	to write poetry, also POETIZE [v POETISED, POETISING, POETISES]
POINADO	a small dagger, also PONIARD, POIGNADO [n POINADOES]
POINDER	one who impounds (to seize and retain in legal custody) [n -S]
POINTED	POINT, to indicate direction with the finger [v]
POITREL	a piece of armour for the breast of a horse, also PEYTRAL, PEYTREL [n -S]
POLACRE	a polonaise [n -S]
POLECAT	a carnivorous mammal [n -S]
POLENTA	a thick mush of cornmeal [n -S]
POLICER	one that polices (to make orderly) [n -S]
POLITER	POLITE, showing consideration for others [adj]
POLONIE	a child's polonaise, also POLONY [n -S]
PONCEAU	a red dye [n PONCEAUS or PONCEAUX]
PONCIER	PONCY, effeminate, also PONCEY [adj]
PONDAGE	the capacity of a pond [n -S]
PONGIER	PONGY, smelly (having an unpleasant odour) [adj]
PONIARD	a small dagger, also POIGNADO, POINADO [n -S] / to stab with this small dagger [v -ED, -ING, -S]
PONTAGE	a toll paid on bridges [n -S]
PONTINE	pertaining to bridges [adj]
POOREST	POOR, lacking the means of support [adj]
POOTERS	POOTER, an entomological collecting bottle [n]
PORANGI	(Maori) crazy [adj]
PORCINE	pertaining to swine (a domestic pig) [adj]
PORGIES	PORGY, an American sea fish, also PORGIE [n]
PORNIER	PORNY, pornographic [adj]
PORTAGE	to transport from one navigable waterway to another [v PORTAGED, PORTAGING, PORTAGES]
PORTATE	in heraldry, in a carrying position [adj]
PORTEND	to serve as an omen of [v -ED, -ING, -S]
PORTENT	an omen [n -S]
PORTIER	PORTY, of the taste of port [adj]
PORTING	PORT, to shift to the left side [v]
PORTION	to divide into shares for distribution [v -ED, -ING, -S]
PORTMEN	PORTMAN, a citizen of a borough, also BURGESS [n]
POSAUNE	the trombone (a brass wind instrument) [n -S]
POSTAGE	the charge for mailing an item [n -S]
POSTEEN	an Afghan sheepskin coat, also POSHTEEN, POSTIN [n -S]
POSTURE	to assume a particular position [v POSTURED, POSTURING, POSTURES]
POTABLE	a liquid suitable for drinking [n -S]
POTAGER	a decorative vegetable garden [n -S]
POTAGES	POTAGE, a thick soup [n]
POTEENS	POTEEN, Irish whiskey distilled unlawfully, also POTHEEN, POTTEEN, POITIN [n]
POTHEAD	one who smokes marijuana [n -S]
POTTEEN	Irish whiskey distilled unlawfully, also POTEEN, POTHEEN, POITIN [n -S]
POTTIER	POTTY, crazy (insane (mentally unsound)) [adj]
POTTIES	POTTY, a child's chamber pot [n]
POULTER	one who deals in poultry [n -S]
POUNDER	one that pounds (to strike heavily and repeatedly) [n -S]
POURIES	POURIE, a cream jug [n]
POUTERS	POUTER, one that pouts (to protrude the lips in ill humour) [n]
POUTIER	POUTY, tending to pout [adj]
POUTINE	a dish of french fries and cheese curds topped with gravy [n -S]
POWNIES	POWNY, a pony, also POWNEY, POWNIE [n]
PRAETOR	an ancient Roman magistrate, also PRETOR [n -S]
PRAIRIE	a grass-covered treeless plain [n -S]
PRANGED	PRANG, to cause to crash [v]
PRATING	the act of prating [n -S]
PREAGED	previously aged [adj]
PREANAL	situated in front of the anus [adj]
PREASED	PREASE, to press, also PREACE, PREASSE [v]
PREBOIL	to boil beforehand [v -ED, -ING, -S]
PREDATE	to date before the true date [v PREDATED, PREDATING, PREDATES]
PREEDIT	to edit beforehand [v -ED, -ING, -S]
PREEING	PREE, to test by tasting [v]
PREHEAT	to heat beforehand [v -ED, -ING, -S]
PRELATE	a high ranking clergyman [n -S]
PRELOAD	to load beforehand [v -ED, -ING, -S]
PRELUDI	PRELUDIO, a prelude [n]
PRENAME	a forename (a first name) [n -S]
PRENTED	PRENT, to print (to produce by pressed type on a surface) [v]
PREORAL	towards the front of the mouth [adj]
PRERIOT	preceding a riot [adj]
PRESAGE	to foretell (to tell about in advance) [v PRESAGED, PRESAGING, PRESAGES]
PRESONG	before a song [adj]
PRETEND	to make believe [v -ED, -ING, -S]
PRETOLD	PRETELL, to tell beforehand, pa t PRETOLD [v]
PREVAIL	to triumph (to be victorious) [v -ED, -ING, -S]
PRIDIAN	relating to yesterday [adj]
PRIMATE	any of an advanced order of mammals, also PRIMATAL [n -S]
PRINTED	PRINT, to produce by pressed type on a surface [v]
PRINTER	one that prints (to produce by pressed type on a surface) [n -S]
PRITHEE	used to express a request, also PRYTHEE [interj]
PRIVATE	a soldier of lower rank [n -S] / secluded from the sight, presence or intrusion of others [adj PRIVATER, PRIVATEST]
PROBATE	to establish the validity of a will [v PROBATED, PROBATING, PROBATES]
PROETTE	a female professional athlete [n -S]
PROFANE	to treat with irreverence or insult [v PROFANED, PROFANING, PROFANES]
PROFILE	to draw an outline of [v PROFILED, PROFILING, PROFILES]
PROINED	PROINE, to prune, also PROIN, PROYN, PROYNE [v]
PROLATE	to lengthen out in utterance [v PROLATED, PROLATING, PROLATES]
PROMINE	a substance that promotes growth [n -S]
PROMISE	to make a declaration of assurance [v PROMISED, PROMISING, PROMISES]
PRONAOI	PRONAOS, a vestibule in front of a temple [n]
PRONATE	to turn the palm downward or backward [v PRONATED, PRONATING, PRONATES]
PRONGED	PRONG, to pierce with a pointed object [v]
PRONOTA	PRONOTUM, a hard outer plate of an insect [n]
PRORATE	to divide proportionately [v PRORATED, PRORATING, PRORATES]
PROSIER	PROSY, pertaining to prose, also PROSAIC [adj]
PROTEAN	a type of protein (a nitrogenous organic compound, also PROTEID, PROTEIDE) [n -S]
PROTEGE	one whose career is promoted by an influential person [n -S]
PROTEID	a nitrogenous organic compound, also PROTEIN, PROTEIDE [n -S]
PROTEND	to extend (to expand (to increase in size or volume)) [v -ED, -ING, -S]
PROTEUS	any of the rodlike bacteria found in decaying matter [n PROTEUSES or PROTEI]
PROVIDE	to supply (to provide with service or goods) [v PROVIDED, PROVIDING, PROVIDES]
PROVINE	to propagate by layering [v PROVINED, PROVINING, PROVINES]
PRUDENT	cautious, wise and discreet in conduct [adj]
PRUINAS	PRUINA, a powdery bloom upon the surface of plants [n]
PRUINES	PRUINE, a prune, also PREWYN [n]
PRUNTED	ornamented with a prunt [adj]
PTEROIC	as in pteroic acid, the original folic acid found in spinach [adj]
PTOMAIN	a compound produced by the decomposition of protein, also PTOMAINE [n -S]
PUDSIER	PUDSY, short and fat, also PUDGY, PODGY, PUDSEY [adj]
PUERILE	childish (like a child) [adj]
PUERING	PUER, to tan leather with dog faeces [v]
PUGAREE	a cloth band wrapped around a hat, also PUGREE, PUGGAREE, PUGGREE, PUGGRY [n -S]
PUIREST	PUIR, poor (lacking the means of support) [adj]
PULIEST	PULY, sickly (inclined to be ailing) [adj]
PULSATE	to expand and contract rhythmically, also PULSE [v PULSATED, PULSATING, PULSATES]
PUNIEST	PUNY, of inferior size, strength or significance [adj]
PUNTIES	PUNTY, an iron supporting rod used in glassmaking, also PONTIE, PONTIL, PONTILE, PONTY, PUNTEE [n]
PURINES	PURINE, a chemical compound, also PURIN [n]
PURITAN	a person who is strictly moral in conduct [n -S]
PURLINE	a horizontal supporting timber, also PURLIN [n -S]
PUTEALS	PUTEAL, a wall around the top of a well [n]
PUTELIS	PUTELI, a flat-bottomed boat [n]
QUERIDA	a female sweetheart [n -S]
QUIETEN	to make silent (making no noise) [v -ED, -ING, -S]
QUIETER	one who silences (to make quiet (free from noise)) [n -S]
QUINATE	arranged in groups of five [adj]
QUINELA	a bet, also QUINELLA, QUINIELA [n -S]
QUINTAR	an Albanian currency, also QINTAR, QINDAR [n -S]
QUOINED	QUOIN, to wedge (to force apart with wood or metal) [v]
QUOITED	QUOIT, to play a game with a heavy flat ring [v]
QUOITER	one who plays quoits [n -S]
QUORATE	having a quorum [adj]
RABIDER	RABID, affected with rabies [adj]
RADIOED	RADIO, to transmit by wireless [v]
RAFTING	an activity of travelling by raft [n -S]
RAFTMEN	RAFTMAN, one who manages a raft, also RAFTSMAN [n]
RAGTIME	a style of American dance music [n -S]
RAGWEED	a woody herb [n -S]
RAILMAN	a railway employee [n RAILMEN]
RAINBOW	an arc of spectral colours formed in the sky [n -S]
RAINILY	in a rainy manner [adv]
RAISINY	full of raisins [adj]
RAIYATS	RAIYAT, an Indian peasant, also RYOT [n]
RAMEKIN	a cheese dish, also RAMEQUIN [n -S]
RAMENTA	RAMENTUM, a scale formed on the surface of leaves [n]
RAMEOUS	of a branch [adj]
RAMILIE	a type of wig, also RAMILLIE [n -S]
RAMPION	a European plant [n -S]
RAMPOLE	a standing dead tree, also RAMPIKE, RANPIKE [n -S]
RAMTILS	RAMTIL, a tropical plant, also RAMTILLA [n]
RANDILY	in a randy manner [adv]
RANPIKE	a standing dead tree, also RAMPIKE, RAMPOLE [n -S]
RAPHIDE	a needle-shaped crystal occurring in plant cells, also RAPHIS [n -S]
RAPIDER	RAPID, swift (speedy (swift)) [adj]
RAREBIT	a cheese dish [n -S]
RATABLE	capable of being rated [adj] / property which may be rated, also RATEABLE [n -S]
RATAFEE	an almond-flavoured liqueur, also RATAFIA [n -S]
RATHOLE	a hole made by a rat [n -S]
RAVELED	RAVEL, to untwist (to untwine (to separate twisted or tangled parts)) [v]
RAVENED	RAVEN, to devour greedily, also RAVIN [v]
RAVENER	one that ravens (to devour greedily, also RAVIN) [n -S]
RAVIOLI	an Italian pasta dish [n -S]
RAWBONE	gaunt (emaciated, also GANT) [adj]
RAWHIDE	to beat with a type of whip [v RAWHIDED, RAWHIDING, RAWHIDES]
REACTED	REACT, to respond to a stimulus [v]
REACTOR	one who reacts (to respond to a stimulus) [n -S]
READAPT	to adapt again [v -ED, -ING, -S]
READIED	READY, to make preparation [v]
READOPT	to adopt again [v -ED, -ING, -S]
REALIZE	to accomplish, also REALISE [v REALIZED, REALIZING, REALIZES]
REALLIE	to form again [v REALLIED, REALLIES]
REALLOT	to allot again [v REALLOTTED, REALLOTTING, REALLOTS]
REAMEND	to amend again [v -ED, -ING, -S]
REAMIER	REAMY, creamy (having the consistency of cream) [adj]
REAVAIL	to avail again [v -ED, -ING, -S]
REAVOWS	REAVOW, to vow again [v]
REBADGE	to market a product under a new brand name [v REBADGED, REBADGING, REBADGES]
REBATED	REBATE, to give a discount for payment [v]
REBATER	one that rebates (to give a discount for payment) [n -S]
REBEGAN	REBEGIN, to begin again [v]
REBEGIN	to begin again [v REBEGAN, REBEGUN or REBEGAN, REBEGINNING, REBEGINS]
REBLENT	REBLEND, to blend again [v]
REBOANT	resounding loudly [adj]
REBOARD	to board again [v -ED, -ING, -S]
REBOOTS	REBOOT, to renew the boots of [v]
REBOUND	to spring back [v -ED, -ING, -S]
REBUILD	to build again [v REBUILDED, REBUILT, REBUILDING, REBUILDS]
REBUILT	REBUILD, to build again [v]
RECANED	RECANE, to replace the cane of [v]
RECEIPT	to mark as having been paid [v -ED, -ING, -S]
RECHATE	the call to hounds [n -S]
RECHEAT	to sound a hunting call [v -ED, -ING, -S]
RECITED	RECITE, to say from memory [v]
RECITER	one who recites (to say from memory) [n -S]
RECLADS	RECLAD, to clad again [v]
RECLAIM	to make suitable for cultivation of habitation [v -ED, -ING, -S]
RECLEAN	to clean again [v -ED, -ING, -S]
RECLINE	to lean or lie back [v RECLINED, RECLINING, RECLINES]
RECLOSE	to close again [v RECLOSED, RECLOSING, RECLOSES]
RECODES	RECODE, to code again [v]
RECOUNT	to relate in detail [v -ED, -ING, -S]
RECRATE	to crate again [v RECRATED, RECRATING, RECRATES]
RECUILE	to force back, also RECULE [v RECUILED, RECUILING, RECUILES]
RECUSAL	the act of recusing (to disqualify or challenge as judge in a particular case) [n -S]
REDATED	REDATE, to change the date [v]
REDBONE	a hunting dog [n -S]
REDCOAT	a British soldier during the American Revolution [n -S]
REDFOOT	a foot disease of lambs [n -S]
REDOUBT	to fear (to be afraid of) [v -ED, -ING, -S]
REDWING	a European thrush [n -S]
REEDILY	with a thin, piping sound [adv]
REEDMAN	one who plays a reed instrument [n REEDMEN]
REEFING	the act of reefing [n -S]
REELMAN	a reel operator [n REELMEN]
REENDOW	to endow again [v -ED, -ING, -S]
REEVING	REEVE, to fasten by passing through or around something [v]
REFILED	REFILE, to file again [v]
REFILES	REFILE, to file again [v]
REFINED	REFINE, to free from impurities [v]
REFINER	one that refines (to free from impurities) [n -S]
REFLATE	to inflate again [v REFLATED, REFLATING, REFLATES]
REFLIES	REFLY, to fly again [v]
REFLOAT	to launch again [v -ED, -ING, -S]
REFOOTS	REFOOT, to replace the foot of [v]
REFOUND	to found again [v -ED, -ING, -S]
REFRAIN	to keep oneself from action [v -ED, -ING, -S]
REFRONT	to put on a new front [v -ED, -ING, -S]
REFUGIA	REFUGIUM, a stable area during a period of continental climatic change [n]
REFUSAL	the act of refusing (to decline to take or accept) [n -S]
REFUTAL	the act of refuting (to prove to be false or erroneous, also REBUT) [n -S]
REGIFTS	REGIFT, to take a gift that has been received and give it to somebody else, sometimes in the guise of a new gift [v]
REGIMEN	a systematic plan [n -S]
REGIMES	REGIME, a system of government [n]
REGIVEN	REGIVE, to give again [v]
REGIVES	REGIVE, to give again [v]
REGMATA	REGMA, a type of fruit [n]
REHANGS	REHANG, to hang again [v]
REHINGE	to hinge again [v REHINGED, REHINGING, REHINGES]
REHOUSE	to establish in a new housing unit [v REHOUSED, REHOUSING, REHOUSES]
REIFIED	REIFY, to regard as real or concrete [v]
REIFIES	REIFY, to regard as real or concrete [v]
REIMAGE	to fix the image of [v REIMAGED, REIMAGING, REIMAGES]
REINDEX	to index again [v -ED, -ING, -ES]
REINKED	REINK, to ink again [v]
REITBOK	an African antelope, also REEDBUCK [n -S]
REIVING	REIVE, to plunder (to rob by force) [v]
REJONES	REJON, a bullfighting lance [n]
RELACED	RELACE, to do up again [v]
RELATUM	a term in a proposition that is related to the referent of the proposition [n RELATA]
RELAYED	RELAY, to put down new flooring [v]
RELIEFS	RELIEF, aid in the form of money or necessities [n]
RELIEVO	the projection of figures or forms from a flat background, also RILIEVO [n -S]
RELIGHT	to light again [v RELIGHTED, RELIT, RELIGHTING, RELIGHTS]
RELIVED	RELIVE, to experience again [v]
RELIVES	RELIVE, to experience again [v]
RELLENO	a Mexican dish of a stuffed and fried green chile [n -S]
RELYING	RELY, to depend on confidently [v]
REMADES	REMADE, a thing made over [n]
REMANIE	a fossil (the preserved remains of a plant or animal) [n -S]
REMATED	REMATE, to mate again [v]
REMBLAI	earth used for a rampart [n -S]
REMEADS	REMEAD, to cure, also REMEDE [v]
REMIGES	REMEX, a flight feather of a bird's wing [n]
REMNANT	something remaining [n -S]
REMODEL	to make over [v REMODELED or REMODELLED, REMODELLING, REMODELS]
REMORAS	REMORA, a type of marine fish [n]
REMORID	pertaining to a remora (a type of marine fish) [adj]
REMOTER	REMOTE, situated far away [adj]
REMOUNT	to climb in a horse once more [v -ED, -ING, -S]
REMOVAL	the act of removing (to transfer to another place) [n -S]
REMUAGE	the process of turning wine bottles [n -S]
REMUDAS	REMUDA, a herd of horses [n]
RENAMED	RENAME, to issue with a new name [v]
RENAYED	RENAY, to renounce (to disown (to deny the ownership of)) [v]
RENEWAL	the act of renewing [n -S]
REOPENS	REOPEN, to open again [v]
REPANEL	to panel again [v REPANELLED, REPANELLING, REPANELS]
REPINED	REPINE, to express discontent [v]
REPINER	one who repines (to express discontent) [n -S]
REPLANT	to plant again [v -ED, -ING, -S]
REPLATE	to plate again [v REPLATED, REPLATING, REPLATES]
REPLEAD	to plead again [v REPLEADED, REPLED, REPLEADING, REPLEADS]
REPLICA	a copy or reproduction [n -S]
REPLIED	REPLY, to answer (to reply) [v]
REPLIES	REPLY, to answer (to reply) [v]
REPOMAN	one who repossesses unpaid-for goods [n REPOMEN]
REPONED	REPONE, to restore to office [v]
REPONES	REPONE, to restore to office [v]
REPOSED	REPOSE, to lie at rest [v]
REPRINT	to print again [v -ED, -ING, -S]
REPTANT	creeping or crawling [adj]
REPTILE	any of a class of cold-blooded, breathing vertebrates [n -S]
REQUITE	to repay (to pay back) [v REQUITED, REQUITING, REQUITES]
REQUOTE	to quote again [v REQUOTED, REQUOTING, REQUOTES]
REREMAI	the basking shark [n -S]
RESAWED	RESAW, to saw again [v]
RESHOED	RESHOE, to shoe again [v]
RESHONE	RESHINE, to shine again [v]
RESHOOT	to film a scene again [v RESHOT, RESHOOTING, RESHOOTS]
RESIGHT	to sight again [v -ED, -ING, -S]
RESOLVE	to analyse (to separate a whole into parts) [v RESOLVED, RESOLVING, RESOLVES]
RESOWED	RESOW, to sow again [v]
RESPADE	to turn over soil again [v RESPADED, RESPADING, RESPADES]
RETABLE	a raised shelf above an altar [n -S]
RETAMAS	RETAMA, a name for various desert plants [n]
RETAPED	RETAPE, to tape again [v]
RETAXED	RETAX, to tax again [v]
RETEACH	to teach again [v RETAUGHT, RETEACHING, RETEACHES]
RETIARY	resembling a net [adj]
RETICLE	a network of lines in the eyepiece of an optical instrument [n -S]
RETIMED	RETIME, to time again [v]
RETRACE	to go back over [v RETRACED, RETRACING, RETRACES]
RETYING	RETIE, to tie again [v]
REVALUE	to value again [v REVALUED, REVALUING, REVALUES]
REVILED	REVILE, to assail with bitter abuse [v]
REVILES	REVILE, to assail with bitter abuse [v]
REVISIT	to visit again [v -ED, -ING, -S]
REVISOR	one who revises, also REVISER [n -S]
REVOICE	to voice again [v REVOICED, REVOICING, REVOICES]
REVOTED	REVOTE, to vote again [v]
REVUIST	a writer of revues [n -S]
REWATER	to water again [v -ED, -ING, -S]
REWIDEN	to widen again [v -ED, -ING, -S]
REWOUND	REWIND, to wind again [v]
REWRITE	to write again [v REWROTE, REWRITING, REWRITES]
REWROTE	REWRITE, to write again [v]
REZONED	REZONE, to zone again [v]
REZONES	REZONE, to zone again [v]
RIANTLY	in a cheerful manner [adv]
RIBANDS	RIBAND, a ribbon [n]
RICIEST	RICY, like rice [adj]
RICOTTA	an Italian cheese [n -S]
RIDLEYS	RIDLEY, a sea turtle [n]
RIEVING	RIEVE, to rob (to steal (to take by theft)) [v]
RIGHTED	RIGHT, to make correct (free from error) [v]
RIGHTEN	to set right [v -ED, -ING, -S]
RILIEVO	the projection of figures or forms from a flat background, also RELIEVO [n RILIEVI]
RIMAYES	RIMAYE, a bergschrund, a crevasse formed where a glacier or snowfield moves away from a mountain wall [n]
RIMIEST	RIMY, frosty (covered with frost) [adj]
RIMLAND	an outlying area [n -S]
RINGTAW	a game of marbles [n -S]
RIOTIZE	riot, also RIOTISE [n -S]
RIPENED	RIPEN, to become ripe (fully matured) [v]
RIPENER	one that ripens (to become ripe (fully matured)) [n -S]
RIPIENO	a musical passage performed by all the performers [n RIPIENOS or RIPIENI]
RIPTIDE	a tide that opposes other tides [n -S]
RIVAGES	RIVAGE, a coast, shore or bank [n]
RIVERET	a small river (a large natural stream of water) [n -S]
RIVETED	RIVET, to fasten with a type of metal bolt [v]
RIVETER	one that rivets (to fasten with a type of metal bolt) [n -S]
RIVIERA	a costal resort area [n -S]
RIVULET	a small stream [n -S]
ROACHED	ROACH, to cause to arch [v]
ROACHES	ROACH, to cause to arch [v]
ROADMEN	ROADMAN, a man who repairs roads [n]
ROAMERS	ROAMER, one who roams (to move about without purpose or plan) [n]
ROAMING	the act of roaming [n -S]
ROARIER	ROARY, noisy, also RORIE [adj]
ROBINIA	an plant of the locust genus [n -S]
RODEWAY	a road, also ROADWAY [n -S]
RODLIKE	like a rod [adj]
ROMAGES	ROMAGE, tumult [n]
ROMAINE	a variety of lettuce [n -S]
ROMANCE	to woo (to count (to number (to count))) [v ROMANCED, ROMANCING, ROMANCES]
ROMAUNT	a long, medieval narrative [n -S]
ROMNEYA	a plant with large white flowers [n -S]
ROOFIES	ROOFIE, a tablet of a powerful sedative [n]
ROOIKAT	a South African lynx [n -S]
ROOINEK	an Afrikaans nickname for the British [n -S]
ROOKIES	ROOKIE, a novice (a beginner (a novice)) [n]
ROOMIES	ROOMIE, a roommate (one who shares a room) [n]
ROPABLE	very angry [adj]
RORTIER	RORTY, rowdy (disorderly in behavior) [adj]
ROSACEA	a skin disease [n -S]
ROSEBAY	an evergreen shrub [n -S]
ROSEHIP	the fruit of the rose [n -S]
ROTCHIE	the little auk [n -S]
ROTIFER	a microscopic aquatic organism [n -S]
ROUGHEN	to make rough (uneven (not even)) [v -ED, -ING, -S]
ROUGHIE	a dry bough, also ROUGHY [n -S]
ROUILLE	a peppery garlic sauce [n -S]
ROULEAU	a roll of coins wrapped in paper [n ROULEAUS or ROULEAUX]
ROUNCES	ROUNCE, part of a hand printing press [n]
ROUPIER	ROUPY, hoarse, also ROUPET [adj]
ROUTHIE	plentiful [adj ROUTHIER, ROUTHIEST]
ROWABLE	able to be rowed [adj]
ROWDIER	ROWDY, disorderly in behavior [adj]
ROWELED	ROWEL, to prick with a spiked wheel in order to urge forward [v]
ROWTING	ROWT, to rummage out [v]
ROYALET	a petty king [n -S]
ROZETED	ROZET, to rosin (to treat with a brittle resin, also ROSET) [v]
ROZITED	ROZIT, to rosin (to treat with a brittle resin, also ROSET) [v]
RUBEOLA	a virus disease [n -S]
RUBIEST	RUBY, of a deep red colour [adj]
RUBINES	RUBINE, a ruby, a precious stone, also RUBIN [n]
RUCTION	a noisy disturbance, also RUCKUS [n -S]
RUELLIA	a plant of the acanthus family [n -S]
RUMINAL	pertaining to a rumen (a part of the stomach of a ruminant) [adj]
SABERED	SABER, to strike with a type of sword, also SABRE [v]
SAINTLY	befitting a saint [adj SAINTLIER, SAINTLIEST]
SALVETE	a general "all hail" [n -S]
SALVOED	SALVO, to discharge firearms simultaneously [v]
SANDPIT	a pit dug in sandy soil [n -S]
SANTIMI	SANTIMS, a former coin of Latvia [n]
SANTIMU	SANTIMS, a former coin of Latvia [n]
SAPROBE	an organism that lives on decaying matter [n -S]
SARCINA	a spherical bacterium [n SARCINAS or SARCINAE]
SARCOID	a disease of horses [n -S]
SATANIC	extremely evil [adj]
SATIETY	the state of being satiated [n SATIETIES]
SATIRIC	pertaining to satire (the use of ridicule or scorn to criticise folly or vice) [adj]
SATYRID	a brownish butterfly [n -S]
SAUCIER	a chef who specializes in sauces [n -S]
SAVANTE	a woman of great learning [n -S]
SAVARIN	a ring-shaped cake made with yeast [n -S]
SAVIOUR	one who saves, also SAVIOR [n -S]
SAVORER	one that savors, also SAVOURER [n -S]
SCALDER	that which scalds [n -S]
SCALENE	designating a triangle having no two sides equal [adj]
SCARIER	SCARY, frightening, also SCAREY [adj]
SCAURED	SCAUR, to frighten (to make afraid, to scare, also FRIGHT) [v]
SCOOTER	a two-wheeled vehicle [n -S]
SCOPATE	tufted [adj]
SCOTTIE	a short-legged terrier [n -S]
SCOURIE	a young gull [n -S]
SCOUTER	one who scouts (to reconnoitre) [n -S]
SCOWRIE	a young gull [n -S]
SCREAMO	a form of emo music typically featuring screaming vocals [n -S]
SEABOOT	a waterproof boot [n -S]
SEAFOOD	edible fish or shellfish from the sea [n -S]
SEAMAID	a mermaid (a fabulous creature with a woman,s body and a fish's tail) [n -S]
SEARCED	SEARCE, to sift (to pass through a strainer, also SIEVE) [v]
SEAWANT	former form of currency used by N.American Indians, also SEAWAN, SEWAN [n -S]
SEAWARE	seaweed used as fertilizer [n -S]
SEAWIFE	a kind of wrasse, a bony fish [n SEAWIVES]
SEAWORM	a marine worm [n -S]
SECONDE	a position in fencing [n -S]
SECONDI	SECONDO, the lower part in a piano duet [n]
SECULAR	a layman (a member of the laity) [n -S]
SEEDMAN	a dealer in seeds, also SEEDSMAN [n SEEDMEN]
SEEMING	outward appearance [n -S]
SEEPING	SEEP, to pass slowly through small openings [v]
SEEWING	SUE, to institute legal proceedings against [v]
SELECTA	a disc jockey [n -S]
SELENIC	pertaining to selenium (a nonmetallic element) [adj]
SEMATIC	serving as a warning [adj]
SEMEION	a unit of time [n SEMEIA]
SEMILOG	having one scale logarithmic and the other arithmetic [adj]
SEMIPRO	one who is engaged in paid sport part-time [n -S]
SEMIRAW	somewhat raw [adj]
SENECIO	a flowering plant [n -S]
SEPTAGE	the waste in a septic tank [n -S]
SEPTUOR	a group of seven, also SEPTET, SEPTETTE [n -S]
SEQUOIA	a large evergreen tree [n -S]
SERFAGE	serfdom (the state of being a serf, also SERFHOOD) [n -S]
SERICIN	a kind of protein [n -S]
SEROVAR	a group of microorganisms having a characteristic set of antigens [n -S]
SERPIGO	a spreading skin eruption [n SERPIGOS or SERPIGINES or SERPIGOES]
SERUMAL	pertaining to serum (the watery portion of whole blood) [adj]
SERVILE	a submissive person [n -S]
SHAITAN	an evil spirit, also SHEITAN [n -S]
SHARIAT	a body of Islamic religious law, also SHARIA, SHARIAH, SHERIA, SHERIAT [n -S]
SHEARED	SHEAR, to cut the wool or hair from [v]
SHERANG	in the phrase the head sherang, the person in charge [n -S]
SHEROOT	a square-cut cigar, also CHEROOT [n -S]
SHINIER	SHINY, filled with light [adj]
SHOALED	SHOAL, to become shallow (having little depth) [v]
SHOOTER	one who shoots (to hit, injure or kill with a missile) [n -S]
SHORTIA	a perennial herb [n -S]
SHOUTER	one who shouts (to yell loudly) [n -S]
SHOWIER	SHOWY, making a brilliant display [adj]
SHRINAL	of a shrine [adj]
SIDEMEN	SIDEMAN, a member of a jazz band [n]
SIGHTER	one that sights (to view (to look at)) [n -S]
SIGMATE	to add a sign to [v SIGMATED, SIGMATING, SIGMATES]
SILENCE	to make quiet (free from noise) [v SILENCED, SILENCING, SILENCES]
SIMARRE	a loose coat [n -S]
SIMITAR	a curved oriental sword, also SCIMITAR, SCIMETAR, SCIMITER, SEMITAR, SEMITAUR, SYMITAR, SYMITARE [n -S]
SINEWED	SINEW, to strengthen [v]
SINOPIA	a red pigment [n SINOPIAS or SINOPIE]
SINOPIE	SINOPIA, a red pigment [n]
SIRENIC	pertaining to a sirenian (any of an order of aquatic mammals) [adj]
SIRUPED	SIRUP, to make into syrup [v]
SIXAINE	a stanza of six lines, also SIXAIN [n -S]
SMEARED	SMEAR, to spread with something oily or sticky [v]
SNAFUED	SNAFU, to cause confusion [v]
SNEAPED	SNEAP, to chide (to scold (to rebuke harshly)) [v]
SNIDELY	in a snide manner [adv]
SNIPIER	SNIPY, snipe-beaked [adj]
SNOOPER	one who snoops (to pry about) [n -S]
SOAPIES	SOAPIE, a serial melodrama on radio or television, also SOAPER [n]
SOAPING	SOAP, to treat with a cleansing agent [v]
SOBERED	SOBER, to make sober [v]
SOCAGER	a tenant by socage, also SOCKMAN, SOCMAN, SOKEMAN [n -S]
SOCIETY	an organized group, a fellowship, also SODALITY [n SOCIETIES]
SOLACED	SOLACE, to console (to comfort (to console)) [v]
SOLVENT	a substance capable of dissolving others [n -S]
SOMNIAL	pertaining to dreams [adj]
SONANCE	sound [n -S]
SOOTHER	to flatter (to praise excessively) [v -ED, -ING, -S]
SOREHON	a lords exaction of free accommodation from a tenant [n -S]
SOUPIER	SOUPY, foggy (filled with fog) [adj]
SOUTHER	to move towards the south [v -ED, -ING, -S]
SOYBEAN	the seed of a cultivated Asian herb [n -S]
SPALTED	SPALT, to split (to separate lengthwise) [v]
SPAROID	any of a family of marine fishes, also SPARID [n -S]
SPATULE	a mixing implement, also SPATULA [n -S]
SPAVIET	relating to a spavie [adj]
SPEANED	SPEAN, to wean (to take off mother's milk) [v]
SPEARED	SPEAR, to pierce with a long pointed weapon [v]
SPELDIN	a haddock (a food fish) [n -S]
SPELEAN	living in caves, also SPELAEAN [adj]
SPICATE	pertaining to a spica (an ear of grain) [adj]
SPIELER	one who spiels (to talk at length) [n -S]
SPINDLE	to impale on a slender rod [v SPINDLED, SPINDLING, SPINDLES]
SPINIER	SPINY, covered with thorns, also SPINOSE, SPINOUS [adj]
SPINODE	the cusp of a point [n -S]
SPINONE	as in Italian spinone, a wiry-coated big-eared gun dog [n SPINONI]
SPINULE	a small thorn, also SPINULA [n -S]
SPLINED	SPLINE, to provide with a key to make a wheel and shaft revolve [v]
SPONDEE	a type of metrical foot, also SPONDAIC [n -S]
SPONGER	one who sponges (to wipe with absorbent material) [n -S]
SPOTTIE	(New Zealand) a deer up to three months old [n -S]
SPOUTER	one that spouts (to eject in a rapid stream) [n -S]
STABLED	STABLE, to put in a shelter for animals [v]
STAITHE	a coal wharf [n -S]
STAMINA	endurance [n -S]
STAPLED	STAPLE, to fasten with a U-shaped metal clip [v]
STATICE	a flowering plant [n -S]
STATIVE	a verb that expresses a condition [n -S]
STEAMIE	a public laundry [n -S]
STEMING	STEM, to deprive a plant of a leaf-bearing axis [v]
STENGAH	a mixed drink [n -S]
STERNLY	in a stern manner [adv]
STEWING	the act of stewing [n -S]
STIFLED	STIFLE, to smother (to prevent from breathing) [v]
STIPULE	an appendage at the base of a leaf [n -S]
STIVIER	STIVY, stuffy (poorly ventilated) [adj]
STOMATE	a minute opening in the epidermis of a plant organ, also STOMA [n -S]
STOMPIE	(South Africa) a cigarette butt; a short man [n -S]
STOOKIE	(Scots) a statue [n -S]
STOOPER	one that stoops (to bend the body forward and down) [n -S]
STOWAGE	goods in storage [n -S]
STRUMAE	STRUMA, a disease of the lymph glands, also SCROFULA [n]
STUIVER	a former Dutch coin, also STIVER [n -S]
SUBDEAN	a subordinate dean [n -S]
SUBEDAR	a governor of a subah, also SUBAHDAR, SUBADAR [n -S]
SUBEDIT	to act as assistant editor [v -ED, -ING, -S]
SUBERIN	a substance found in cork cells [n -S]
SUBIDEA	an inferior idea [n -S]
SUBLATE	to cancel (to annul (to declare void)) [v SUBLATED, SUBLATING, SUBLATES]
SUBLINE	an inbred line within a strain [n -S]
SUBTILE	insidious, also SUBTLE [adj SUBTILER, SUBTILEST]
SUBTONE	a low or subdued tone [n -S]
SUDAMEN	a whitish vesicle of sweat in a duct [n SUDAMINA]
SULCATE	having long, narrow furrows, also SULCATED [adj]
SULFATE	to treat with sulfuric acid, also SULPHATE [v SULFATED, SULFATING, SULFATES]
SULFITE	a chemical salt, also SULPHITE [n -S]
SUNBEAT	over exposed to the sun [adj]
SURAMIN	a drug [n -S]
SURANCE	assurance [n -S]
SURBATE	to bruise (to injure and discolour the skin) [v SURBATED, SURBET or SURBATED, SURBATING, SURBATES]
SURFEIT	to indulge in excess [v -ED, -ING, -S]
SURNAME	to give the family name to [v SURNAMED, SURNAMING, SURNAMES]
SURVEIL	to watch closely [v SURVEILLED, SURVEILLING, SURVEILS]
SWANNIE	in New Zealand, a heavy all-weather woollen shirt [n -S]
SWEEING	SWEE, to sway (to move slowly back and forth) [v]
SWINDLE	to take money or property from by fraudulent means [v SWINDLED, SWINDLING, SWINDLES]
SWIRLED	SWIRL, to move with a whirling motion [v]
SWOONER	one who swoons (to faint, also SWOUN, SWOUND) [n -S]
SYNURAE	SYNURA, any of a genus of protozoa [n]
TABANID	a bloodsucking insect [n -S]
TABERED	TABER, to beat on a small drum, also TABOR, TABOUR [v]
TABINET	a delicate material, also TABBINET [n -S]
TABLOID	a small newspaper [n -S]
TABOOED	TABOO, to exclude or prohibit by social influence, also TABU [v]
TABORED	TABOR, to beat on a small drum, also TABER, TABOUR [v]
TABORER	one who tabors, also TABOURER [n -S]
TABORET	a small drum, also TABORIN, TABORINE, TABOURET [n -S]
TABORIN	a small drum, also TABORET, TABORINE, TABOURET [n -S]
TABOULI	a Lebanese salad, also TABOULEH, TABBOULI, TABBOULEH, TABOOLEY, TABULI [n -S]
TABRERE	a person who bears the tabor [n -S]
TACKIER	TACKEY, adhesive [adj]
TACNODE	a point of contact between two curves [n -S]
TACTILE	pertaining to the sense of touch, also TACTUAL [adj]
TACTION	the act of touching [n -S]
TADPOLE	the aquatic larva of an amphibian [n -S]
TAEDIUM	the state of being tedious, also TEDIUM [n -S]
TAGGIER	TAGGY, matted into tags [adj]
TAGLIKE	like a tag [adj]
TAHINAS	TAHINA, an oily paste [n]
TAHINIS	TAHINI, a paste of sesame seeds [n]
TAILFAN	a fanlike swimming organ of some crustaceans [n -S]
TAILFIN	a fin at the posterior end of a fish [n -S]
TAILLIE	a tax [n -S]
TAILZIE	a limitation of inheritance to certain heirs, also TAILYE [n -S]
TAIPANS	TAIPAN, a venomous snake [n]
TALIPED	a person afflicted with a clubfoot [n -S]
TALLIED	TALLY, to count (to number (to count)) [v]
TAMARIN	a South American monkey [n -S]
TAMARIS	TAMARI, a Japanese soy sauce [n]
TAMPION	a plug for the muzzle of a cannon, also TOMPION [n -S]
TANNERY	a place where hides are tanned [n TANNERIES]
TAPERED	TAPER, to become gradually narrower [v]
TAPERER	one who carries a candle in a religious procession [n -S]
TAPETIS	TAPETI, a rabbit [n]
TAPHOLE	a hole in a blast furnace [n -S]
TARDILY	in a tardy manner [adv]
TARDYON	a subatomic particle that travels slower than the speed of light [n -S]
TARRIER	one who tarries (to linger (to delay departure)) [n -S]
TARWEED	a flowering plant [n -S]
TAUPIES	TAUPIE, a clumsy girl [n]
TAVERED	TAVER, to wander (to roam (to move about without purpose or plan)) [v]
TAVERNA	a cafe in Greece [n -S]
TAWIEST	TAWIE, docile (compliant) [adj]
TAWPIES	TAWPIE, a foolish young person [n]
TEABOWL	a teacup without a handle [n -S]
TEACHER	one who teaches (to instruct (to teach)) [n -S]
TEACHIE	tetchy (irritable, also TECHY) [adj]
TEALIKE	resembling tea [adj]
TEAPOTS	TEAPOT, a pot used to make tea [n]
TEAPOYS	TEAPOY, a small table used in serving tea, also TEPOY [n]
TEARFUL	full of tears [adj]
TEAROOM	a restaurant serving tea [n -S]
TEASHOP	a tearoom (a restaurant serving tea) [n -S]
TEATIME	the usual time for tea [n -S]
TEAWARE	a tea service [n -S]
TEAZING	TEAZE, to make fun of [v]
TECHIER	TECHY, irritable, also TETCHY [adj]
TEDIUMS	TEDIUM, the state of being tedious, also TAEDIUM [n]
TEEMING	TEEM, to be full to overflowing [v]
TEFLONS	TEFLON, synthetic fluorine-containing resins used especially for molding articles and for coatings to prevent sticking (as of food in cookware) [n]
TEINDED	TEIND, to assess (to estimate (to calculate)) [v]
TELAMON	a male figure used as a supporting column [n TELAMONS or TELAMONES]
TELEMAN	a naval officer [n TELEMEN]
TELFORD	a road made of stones [n -S]
TELOMES	TELOME, a structural unit of a vascular plant [n]
TELOMIC	pertaining to a telome (a structural unit of a vascular plant) [adj]
TEMENOS	a sacred precinct [n TEMENE]
TEMPERA	a technique of painting [n -S]
TEMSING	TEMS, to sift (to pass through a strainer, also SIEVE) [v]
TENABLE	capable of being held [adj]
TENFOLD	ten times as much [n -S]
TEPIDER	TEPID, lukewarm (moderately warm) [adj]
TEQUILA	a Mexican liquor, also TEQUILLA [n -S]
TERAOHM	one trillion ohms [n -S]
TEREBIC	pertaining to an acid from oil of turpentine [adj]
TEREBRA	a boring instrument [n TEREBRAS or TEREBRAE]
TEREFAH	not kosher, also TREF, TREIF [adj]
TERMING	TERM, to designate [v]
TERMITE	a white ant [n -S]
TERNARY	a group of three [n TERNARIES]
TERRACE	to form into raised banks [v TERRACED, TERRACING, TERRACES]
TERROIR	the combination of factors, such as soil and climate, that gives a wine its character [n -S]
TETANIC	a drug capable of causing convulsions [n -S]
THALIAN	pertaining to the Muse of comedy [adj]
THANAGE	the land held by a thane, also THENAGE [n -S]
THAWIER	THAWY, inclined to melt [adj]
THEATER	a building for dramatic presentations, also THEATRE [n -S]
THEATRE	a building for dramatic presentations, also THEATER [n -S]
THEEING	THEE, to use the pronoun thee [v]
THEELIN	a female sex hormone, also ESTRIOL, OESTRIOL, ESTRIN, OESTRIN, ESTROGEN, OESTROGEN, ESTRONE, OESTRONE, THEELOL [n -S]
THENAGE	the land held by a thane, also THANAGE [n -S]
THEORIC	theory (an explanation of anything) [n -S]
THEREAT	at that place or time [adv]
THEREON	on that [adv]
THERETO	to that [adv]
THERIAC	molasses, also THERIACA [n -S]
THERMAE	hot springs [n]
THEROID	resembling a beast [adj]
THEWIER	THEWY, muscular (having big strong muscles, also MUSCLY) [adj]
THINNER	something that thins [n -S]
THIRLED	THIRL, to trill (to play with a tremulous sound) [v]
THONDER	yonder [adv]
THONGED	having a thong [adj]
THORIAS	THORIA, an oxide of thorium [n]
THORITE	a thorium ore [n -S]
THORNED	THORN, to prick with a sharp projection on a plant [v]
THREAVE	two dozen [n -S]
THRIVEN	THRIVE, to grow vigorously [v]
THRONED	THRONE, to sit on a royal chair [v]
THUNDER	to produce a loud, resounding sound [v -ED, -ING, -S]
TIDDLER	a small fish [n -S]
TIDERIP	a riptide (a tide that opposes other tides) [n -S]
TIDEWAY	a tidal channel [n -S]
TIERCED	divided into three equal parts [adj]
TIERCEL	a male falcon, also TERCEL, TERCELET [n -S]
TIERCET	a group of three lines that rhyme [n -S]
TIETACS	TIETAC, a tie clip, also TIETACK [n]
TIGERLY	like a tiger [adj]
TILLAGE	cultivated land, also TILTH [n -S]
TIMARAU	a small buffalo of the Philippines, also TAMARAU, TAMARAO [n -S]
TIMBALE	a pastry shell shaped like a drum [n -S]
TIMEOUS	timely (occurring at the right moment) [adj]
TIMEOUT	a brief suspension of activity [n -S]
TIMIDER	TIMID, lacking courage or self-confidence [adj]
TIMPANO	a kettledrum, also TYMPANO [n TIMPANI]
TINAMOU	a South American game bird [n -S]
TINCALS	TINCAL, a crude borax [n]
TINDERY	pertaining to tinder (dry inflammable matter) [adj]
TINKLER	one who tinkles (to make sharp, metallic sounds) [n -S]
TIPSIER	TIPSY, slightly drunk [adj]
TIPTOED	TIPTOE, to walk on the tips of one's toes, also TIPPYTOE [v]
TIPTOES	TIPTOE, to walk on the tips of one's toes, also TIPPYTOE [v]
TIPUNAS	TIPUNA, (Maori) an ancestor, also TUPUNA [n]
TIREDLY	in a tired manner [adv]
TIRONIC	resembling a tiro, also TYRONIC [adj]
TITMOSE	a small bird [n TITMICE]
TOADIED	TOADY, to fawn on or flatter [v]
TOADISH	like a toad [adj]
TOAZING	TOAZE, to tease out [v]
TOCKIER	TOCKY, muddy (covered with mud) [adj]
TOEBIES	TOEBIE, (Afrikaans) a sandwich [n]
TOECAPS	TOECAP, a covering for the front of a boot or shoe [n]
TOECLIP	a foot holder on a pedal [n -S]
TOELIKE	like a toe [adj]
TOHEROA	a New Zealand shellfish [n -S]
TOISECH	a Celtic noble, also TOISEACH [n -S]
TOKENED	TOKEN, to be a sign or mark of [v]
TOLARJI	TOLAR, (Slovene) the standard monetary unit of Slovenia, pl TOLARS, TOLARJI or TOLARJEV [n]
TOLLAGE	a toll [n -S]
TOMENTA	TOMENTUM, a network of small blood vessels [n]
TONEARM	the pivoted part of a record player that holds the needle [n -S]
TONEMES	TONEME, a tonal unit of speech [n]
TONEMIC	pertaining to a toneme (a tonal unit of speech) [adj]
TONEPAD	an electronic device [n -S]
TONETIC	pertaining to tonetics (the phonetic study of tone in language) [adj]
TOOLMEN	TOOLMAN, a man who works with tools [n]
TOOSHIE	upset [adj TOOSHIER, TOOSHIEST]
TOPIARY	the art of trimming shrubs into shape [n TOPIARIES]
TORMENT	to harass or torture [v -ED, -ING, -S]
TORMINA	gripes [n]
TORPEDO	to attack with an underwater missile [v -ED, -ING, -S]
TORTIVE	turned awry [adj]
TOTABLE	able to be toted [adj]
TOTIENT	the number of totitives of a number [n -S]
TOTTIER	TOTTY, dazed [adj]
TOUGHEN	to make tough (strong and resilient) [v -ED, -ING, -S]
TOUGHER	TOUGH, strong and resilient [adj]
TOUGHIE	a tough person, also TOUGHY [n -S]
TOUPEED	having a TOUPEE [adj]
TOUPEES	TOUPEE, a hairpiece worn to cover a bald spot [n]
TOURNEY	to compete in a tournament [v -ED, -ING, -S]
TOUZIER	TOUZY, shaggy (covered with long coarse hair) [adj]
TOWABLE	able to be towed [adj]
TOWAGES	TOWAGE, the price paid for towing [n]
TOWELED	TOWEL, to wipe with an absorbent cloth [v]
TOWERED	TOWER, to rise to a great height [v]
TOWHEAD	a head of light blond hair [n -S]
TOWIEST	TOWY, like flax [adj]
TOWNEES	TOWNEE, a townsman (a resident of a town) [n]
TOWZIER	TOWZY, shaggy (covered with long coarse hair) [adj]
TOXEMIA	the condition of having toxins in the blood, also TOXAEMIA [n -S]
TRACING	something that is traced [n -S]
TRADUCE	to defame (to destroy the reputation of) [v TRADUCED, TRADUCING, TRADUCES]
TRAGEDY	a disastrous event [n TRAGEDIES]
TRANCED	TRANCE, to put into a semiconscious state [v]
TRANCEY	(Of music, etc) creating a hypnotic effect [adj TRANCIER, TRANCIEST]
TRANCHE	a portion [n -S]
TRANECT	a ferry [n -S]
TRAPING	TRAPE, to walk in an aimless manner, also TRAIPSE, TRAPES [v]
TRAVAIL	to toil (to work hard) [v -ED, -ING, -S]
TRAVOIS	a type of sled, also TRAVOISE [n -ES]
TRAWLED	TRAWL, to fish by dragging a net along the bottom of the sea [v]
TRAYNED	TRAYNE, to be instructed [v]
TREACLE	to smear with molasses [v TREACLED, TREACLING, TREACLES]
TREADED	TREAD, to walk on, over, or along [v]
TREETOP	the top of a tree [n -S]
TREFOIL	a plant having three-lobed leaves, also TRIFOLY [n -S]
TREHALA	a sweet substance obtained from a type of beetle [n -S]
TREILLE	a trellis [n -S]
TREMOLO	a vibrating musical effect [n -S]
TRIACID	a type of acid (a type of chemical compound) [n -S]
TRIADIC	a member of a triad [n -S]
TRIAXON	a sponge spicule with three axes, also TRIAXIAL [n -S]
TRIBALS	TRIBAL, a member of a tribe [n]
TRICLAD	an aquatic flatworm [n -S]
TRIFLED	TRIFLE, to waste time [v]
TRILLED	TRILL, to play with a tremulous sound [v]
TRILOBE	something that has three lobes [n -S]
TRIPLED	TRIPLE, to make three times as great [v]
TRIREME	an ancient Greek or Roman warship [n -S]
TRITOMA	an African herb [n -S]
TRIVIAL	insignificant [adj]
TROAKED	TROAK, to exchange, also TROKE, TROCK [v]
TRODDEN	TREAD, to walk on, over, or along [v]
TROIKAS	TROIKA, a Russian carriage [n]
TROMINO	a flat, three-sided shape [n TROMINOS or TROMINOES]
TROOPED	TROOP, to move in a crowd [v]
TROPING	TROPE, to provide with a metaphor [v]
TROUBLE	to distress (to cause anxiety or suffering to) [v TROUBLED, TROUBLING, TROUBLES]
TROUNCE	to beat (to strike repeatedly) [v TROUNCED, TROUNCING, TROUNCES]
TROUPED	TROUPE, to tour with a theatrical company [v]
TROUPES	TROUPE, to tour with a theatrical company [v]
TROWING	TROW, to suppose (to assume to be true) [v]
TRUCAGE	the faking of works of art [n -S]
TRUCIAL	bound by a truce [adj]
TRUEMAN	an honest man [n TRUEMEN]
TRUEMEN	TRUEMAN, an honest man [n]
TRYSAIL	a type of sail [n -S]
TSUNAMI	a huge ocean wave [n -S]
TUNABLE	capable of being tuned, also TUNEABLE [adj]
TUNICAE	TUNICA, a layer of body tissue [n]
TUNICLE	a type of vestment (a ceremonial garment of the clergy) [n -S]
TURACIN	a soluble red pigment [n -S]
TWAITES	TWAITE, a British species of shad [n]
TWANGED	TWANG, to make a sharp, vibrating sound, also TWANGLE [v]
TWANGLE	to make a sharp, vibrating sound, also TWANG [v TWANGLED, TWANGLING, TWANGLES]
TWASOME	a twosome (a pair of two) [n -S]
TWEENIE	a housemaid, also TWEENY [n -S]
TWINGED	TWINGE, to affect with a sharp pain [v]
TWINGES	TWINGE, to affect with a sharp pain [v]
TWINTER	a two year old animal [n -S]
TWIRLED	TWIRL, to rotate rapidly [v]
TWOONIE	a Canadian two-dollar coin, also TOONIE, TWONIE [n -S]
TYRANED	TYRAN, to play the oppressor, also TYRANNE, TYRANT [v]
TYRANNE	to play the oppressor, also TYRAN, TYRANT [v TYRANNED, TYRANNING, TYRANNES]
TZIGANE	a gypsy [n -S]
UILLEAN	as in uillean pipes, an Irish bagpipe [adj]
UNACTED	not acted [adj]
UNADEPT	not adept [adj]
UNAIDED	without aid [adj]
UNAIMED	without aim [adj]
UNAKITE	an igneous rock [n -S]
UNALIKE	not alike [adj]
UNALIVE	lacking in vitality [adj]
UNARMED	UNARM, to deprive of arms [v]
UNAWARE	not aware [adj]
UNBALED	UNBALE, to loosen from a compressed bundle [v]
UNBALES	UNBALE, to loosen from a compressed bundle [v]
UNBARED	UNBARE, to bare (to expose (to lay open to view)) [v]
UNBARES	UNBARE, to bare (to expose (to lay open to view)) [v]
UNBASED	not based [adj]
UNBATED	undiminished [adj]
UNBEARS	UNBEAR, to free from the pressure of a rein [v]
UNBEGOT	UNBEGET, to undo the begetting of [v]
UNBRAID	to separate the strands of [v -ED, -ING, -S]
UNCARED	not cared (for) [adj]
UNCASED	UNCASE, to remove from a case [v]
UNCITED	not cited [adj]
UNCLEAR	not clear [adj UNCLEARER, UNCLEAREST]
UNCOEST	UNCO, strange (unusual (not usual)) [adj]
UNCRATE	to remove from a crate [v UNCRATED, UNCRATING, UNCRATES]
UNDATED	not dated [adj]
UNDEAFS	UNDEAF, to free from deafness [v]
UNDRAPE	to strip of drapery [v UNDRAPED, UNDRAPING, UNDRAPES]
UNDRIED	not dried [adj]
UNEARTH	to dig up [v -ED, -ING, -S]
UNFAIRS	UNFAIR, to deprive of beauty [v]
UNFILDE	unpolished [adj]
UNFILED	not filed [adj]
UNFIRED	not fired [adj]
UNHAIRS	UNHAIR, to remove the hair from [v]
UNHEADS	UNHEAD, to decapitate [v]
UNHEALS	UNHEAL, to disclose (to reveal (to make known)) [v]
UNHEARD	not heard [adj]
UNHEART	to dishearten [v -ED, -ING, -S]
UNHIRED	not hired [adj]
UNHORSE	to cause to fall from a horse [v UNHORSED, UNHORSING, UNHORSES]
UNIFACE	a coin having a design on only one side [n -S]
UNIFIER	one who unifies (to make into a coherent whole) [n -S]
UNIPEDS	UNIPED, a one-footed person or animal [n]
UNITARY	pertaining to a unit (a specific quantity used as a standard of measurement) [adj]
UNITIVE	serving to unite [adj]
UNLACED	UNLACE, to unfasten the laces of [v]
UNLACES	UNLACE, to unfasten the laces of [v]
UNLAWED	UNLAW, to annul (to declare void) [v]
UNLEASH	to free from a leash [v -ED, -ING, -ES]
UNLIMED	UNLIME, to free from lime [v]
UNLIMES	UNLIME, to free from lime [v]
UNLIVED	UNLIVE, to live so as to make amends for [v]
UNLIVES	UNLIVE, to live so as to make amends for [v]
UNMATED	not mated [adj]
UNOAKED	(Of wine) not fermented in an oak cask [adj]
UNPARED	not cut [adj]
UNPILED	UNPILE, to disentangle from a pile [v]
UNPILES	UNPILE, to disentangle from a pile [v]
UNPLAIT	to undo the plaits of [v -ED, -ING, -S]
UNRACED	not raced [adj]
UNRAVEL	to separate the threads of [v UNRAVELED or UNRAVELLED, UNRAVELLING, UNRAVELS]
UNREADY	not ready [adj UNREADIER, UNREADIEST]
UNREAVE	to unweave (to undo something woven) [v UNREAVED, UNREAVING, UNREAVES]
UNRIMED	not rimed [adj]
UNROBED	UNROBE, to undress (to take off clothing) [v]
UNROBES	UNROBE, to undress (to take off clothing) [v]
UNROPED	UNROPE, to loose from a rope [v]
UNROPES	UNROPE, to loose from a rope [v]
UNSAFER	UNSAFE, not safe [adj]
UNSAVED	not saved [adj]
UNSAWED	not sawed [adj]
UNSCALE	to remove the scales from [v UNSCALED, UNSCALING, UNSCALES]
UNSHALE	to reveal (to make known) [v UNSHALED, UNSHALING, UNSHALES]
UNSMOTE	unsmitten [adj]
UNSOBER	not sober [adj]
UNSPIDE	unobserved [adj]
UNSPIED	unobserved [adj]
UNSWEAR	to retract something sworn [v UNSWORE, UNSWORN, UNSWEARING, UNSWEARS]
UNSWORE	UNSWEAR, to retract something sworn [v]
UNTAMED	UNTAME, to make untame [v]
UNTAMES	UNTAME, to make untame [v]
UNTEAMS	UNTEAM, to unyoke (to free from a yoke) [v]
UNTIMED	not timed [adj]
UNTRACE	to loose from traces [v UNTRACED, UNTRACING, UNTRACES]
UNVAILE	to remove one's veil, also UNVAIL [v UNVAILED, UNVAILING, UNVAILES]
UNVEILS	UNVEIL, to remove a covering from [v]
UNVITAL	not vital [adj]
UNVOICE	to deprive of voice [v UNVOICED, UNVOICING, UNVOICES]
UNWARES	unawares (without being aware) [adv]
UNWARIE	not wary, also UNWARY [adj UNWARIER, UNWARIEST]
UNWATER	to drain (to draw off a liquid) [v -ED, -ING, -S]
UNWEALS	UNWEAL, an affliction [n]
UNWIRED	UNWIRE, to take the wire from [v]
UNWIRES	UNWIRE, to take the wire from [v]
UNWISER	UNWISE, not wise [adj]
UNWROTE	UNWRITE, to undo the writing of [v]
UPDATER	one who updates (to bring up to date) [n -S]
UPDATES	UPDATE, to bring up to date [v]
UPDRIES	UPDRY, to dry completely [v]
UPLEANS	UPLEAN, to rest one's weight [v]
UPLEANT	UPLEAN, to rest one's weight [v]
UPRATED	UPRATE, to improve the power output of an engine [v]
UPRATES	UPRATE, to improve the power output of an engine [v]
UPRISEN	UPRISE, to rise up [v]
UPSTAIR	pertaining to an upper floor [adj]
UPSTARE	to stare upward [v UPSTARED, UPSTARING, UPSTARES]
UPTEARS	UPTEAR, to tear out by the roots [v]
UPTRAIN	to educate (to teach (to instruct (to teach))) [v -ED, -ING, -S]
UPTREND	a tendency toward growth [n -S]
URAEMIA	an abnormal condition of the blood, also UREMIA, URINEMIA [n -S]
URAEMIC	pertaining to uraemia (an abnormal condition of the blood, also UREMIA, URINEMIA) [adj]
URANISM	homosexuality [n -S]
URCEOLI	URCEOLUS, a pitcher-shaped structure [n]
UREMIAS	UREMIA, an abnormal condition of the blood, also URAEMIA, URINEMIA [n]
URETHAN	a chemical compound, also URETHANE [n -S]
URICASE	an enzyme (a complex protein, also ENZYM) [n -S]
URTICAS	URTICA, a plant of the nettle genus [n]
UTOPIAN	one who believes in the perfectibility of human society, also UTOPIST [n -S]
UTOPIAS	UTOPIA, a place of perfection [n]
UTRICLE	a saclike cavity in the inner ear, also UTRICULUS [n -S]
VAGINAE	VAGINA, the passage leading from the uterus to the vulva [n]
VAHINES	VAHINE, a Maori woman, also WAHINE [n]
VAIRIER	VAIRY, variegated with vair, also VAIRE [adj]
VALERIC	pertaining to a valerian (a perennial herb) [adj]
VALETED	VALET, to act as a personal servant to [v]
VALETES	VALETE, farewell [n]
VALIANT	a courageous person [n -S]
VALONEA	a tanning material, also VALLONIA, VALONIA [n -S]
VALONIA	a tanning material, also VALLONIA, VALONEA [n -S]
VALUERS	VALUER, one who values (to estimate the worth of) [n]
VANITAS	a Dutch still-life painting [n -ES]
VANTAGE	to benefit (to obtain an advantage) [v VANTAGED, VANTAGING, VANTAGES]
VAPIDER	VAPID, insipid (dull and uninteresting) [adj]
VAPORED	VAPOR, to turn into vapor also VAPOUR [v]
VAREUSE	a loose jacket [n -S]
VARIANT	variable (something that varies) [n -S]
VARIATE	to vary (to make different) [v VARIATED, VARIATING, VARIATES]
VARICES	VARIX, a varicose vein [n]
VARIERS	VARIER, one that varies (to make different) [n]
VARIETY	diversity [n VARIETIES]
VARIOLA	smallpox (a virus disease) [n -S]
VARIOLE	a small fovea, also FOVEOLA, FOVEOLE, FOVEOLET [n -S]
VARIOUS	of diverse kinds [adj]
VARMENT	an animal considered to be a pest, also VARMINT [n -S]
VAULTED	VAULT, to attain great success, also VAUT, VAUTE, VAWTE [v]
VAULTER	one who leaps (to spring off the ground) [n -S]
VAUNTED	VAUNT, to brag (to boast (to brag)) [v]
VAUNTER	one who vaunts (to brag (to boast)) [n -S]
VAUNTIE	boastful, also VAUNTY, VAWNTIE [adj VAUNTIER, VAUNTIEST]
VAURIEN	a good-for-nothing [n -S]
VAWNTIE	boastful, also VAUNTIE, VAUNTY [adj VAWNTIER, VAWNTIEST]
VEALIER	VEALY, immature [adj]
VEALING	VEAL, to kill and prepare a calf for food [v]
VEDALIA	an Australian ladybug [n -S]
VEERING	the act of veering [n -S]
VEGETAL	a plant or vegetable [n -S]
VEILERS	VEILER, one that veils (to wear a piece of sheer fabric) [n]
VEILIER	VEILY, like a veil [adj]
VEINIER	VEINY, full of veins [adj]
VEINLET	a small vein [n -S]
VEINOUS	full of veins [adj]
VEINULE	a small vein, also VENULE, VEINULET [n -S]
VELARIA	VELARIUM, an awning over an ancient Roman theatre [n]
VELARIC	pertaining to the velar [adj]
VELATED	having a velum [adj]
VELETAS	VELETA, a dance in waltz time [n]
VELIGER	a mollusc larva with a velum [n -S]
VELOUTE	a type of sauce [n -S]
VENATIC	pertaining to hunting (an instance of searching) [adj]
VENATOR	a huntsman (a hunter (one who hunts (hunt))) [n -S]
VENDAGE	the grape harvest, also VENDANGE [n -S]
VENISON	the edible flesh of a deer [n -S]
VENTAGE	a small opening (a vacant space) [n -S]
VENTIGE	a finger hole [n -S]
VENTOSE	windy (marked by strong wind) [adj]
VENTRAL	a fin located on the underside of a fish [n -S]
VENTRED	VENTRE, to venture (to risk (to expose to loss or injury)) [v]
VENTURE	to risk (to expose to loss or injury) [v VENTURED, VENTURING, VENTURES]
VENULAR	pertaining to a venule (a small vein, also VEINULE, VEINULET) [adj]
VERANDA	a type of porch, also VERANDAH, VIRANDA, VIRANDO [n -S]
VERBENA	a flowering plant [n -S]
VERDANT	green with vegetation [adj]
VERDITE	green mica [n -S]
VERISMO	realism in art or literature, also VERISM [n -S]
VERMIAN	pertaining to worms [adj]
VERNANT	sprouting in spring [adj]
VERNIER	an auxiliary scale that gives fractional readings [n -S]
VERONAL	a barbitone [n -S]
VERTIGO	dizziness [n VERTIGOS or VERTIGINES or VERTIGOES]
VERTING	VERT, to become a convert [v]
VESICAE	VESICA, a bladder (a thin distended bag) [n]
VESTIGE	a visible sign of something that is no longer in existence [n -S]
VESTING	the act of clothing [n -S]
VETOING	VETO, to forbid or prevent authoritatively [v]
VIATORS	VIATOR, a traveller [n]
VIBRATE	to move back and forward rapidly [v VIBRATED, VIBRATING, VIBRATES]
VIBRATO	a tremulous or pulsating musical effect [n -S]
VICIATE	to render faulty [v VICIATED, VICIATING, VICIATES]
VIDUAGE	widowhood [n -S]
VILAYET	an administrative division of Turkey [n -S]
VINTAGE	to strip of grapes, also VINT [v VINTAGED, VINTAGING, VINTAGES]
VINTNER	a wine merchant [n -S]
VIOLATE	to fail to observe duly, to abuse [v VIOLATED, VIOLATING, VIOLATES]
VIOLONE	a stringed instrument [n -S]
VIRAGOS	VIRAGO, a noisy, domineering woman [n]
VIRANDA	a type of porch, also VERANDA, VERANDAH, VIRANDO [n -S]
VIRANDO	a type of porch, also VERANDA, VERANDAH, VIRANDA [n -S]
VIRELAI	a medieval French verse form, also VIRELAY [n -S]
VIRELAY	a medieval French verse form, also VIRELAI [n -S]
VIREMIA	viruses in the bloodstream, also VIRAEMIA [n -S]
VIRETOT	a rush or a dash [n -S]
VIRGATE	an early English land measure [n -S]
VIRTUAL	having the effect but not the actual form of what is specified [adj]
VIRTUES	VIRTUE, moral excellence, also VERTUE [n]
VISAGED	having a visage [adj]
VISCERA	VISCUS, an internal organ [n]
VISITEE	the person to whom a visit is made [n -S]
VISITER	someone who calls in to see you, also VISITOR, VISITANT [n -S]
VITAMER	a type of chemical compound [n -S]
VITIATE	to impair the value or quality of [v VITIATED, VITIATING, VITIATES]
VITRAGE	a curtain [n -S]
VITRAIL	stained glass [n VITRAUX]
VITRAIN	a separable constituent of bright coal [n -S]
VITULAR	pertaining to a calf, also VITULINE [adj]
VOGIEST	VOGIE, vain (filled with undue admiration for oneself) [adj]
VOGUIER	VOGUEY, modish (stylish (fashionable)) [adj]
VOICERS	VOICER, one who voices (to utter (to give voice to)) [n]
VOIDEES	VOIDEE, a light supper [n]
VOITURE	a carriage (a wheeled horse-drawn vehicle) [n -S]
VOLANTE	a two-wheeled horse vehicle [n -S]
VOLTAGE	electromotive force expressed in volts [n -S]
VOMITED	VOMIT, to eject the contents of the stomach through the mouth [v]
VOMITER	one that vomits (to eject the contents of the stomach through the mouth) [n -S]
VORLAGE	a position in skiing [n -S]
VOTABLE	capable of being voted on, also VOTEABLE [adj]
VOTEENS	VOTEEN, a devotee (an ardent follower) [n]
WAGERED	WAGER, to make a bet [v]
WAGONED	WAGON, to transport in a four wheeled horse-drawn vehicle, also WAGGON [v]
WAGONER	one who drives a waggon, also WAGGONER [n -S]
WAHINES	WAHINE, a Maori woman, also VAHINE [n]
WAINAGE	land under cultivation [n -S]
WAITRON	a server in a restaurant [n -S]
WAIVERS	WAIVER, the act of waiving (to refrain from claiming) [n]
WAIVODE	the leader of an army, also WAIWODE [n -S]
WALDOES	WALDO, a gadget for manipulating objects remotely [n]
WANGLER	one who wangles (to obtain by craft) [n -S]
WANKIER	WANKY, contemptible [adj]
WANTAGE	a shortage (an insufficient supply) [n -S]
WARDIAN	as in wardian case, a case for displaying orchids etc [adj]
WAREHOU	any of several edible New Zealand fish [n -S]
WARSLED	WARSLE, to wrestle (to grapple with, also WRASSLE, WRASTLE, WRAXLE) [v]
WARTIER	WARTY, covered with warts [adj]
WARTIME	a time of war [n -S]
WARZONE	a region of armed conflict [n -S]
WASHIER	WASHY, overly diluted [adj]
WATERED	WATER, to sprinkle with a transparent, odourless, tasteless liquid [v]
WATERER	one that waters (to sprinkle with a transparent, odourless, tasteless liquid) [n -S]
WAVESON	goods floating after a shipwreck [n -S]
WAVIEST	WAVY, having waves, also WAVEY [adj]
WEANELS	WEANEL, a weanling (a recently weaned child or animal) [n]
WEANING	an act of weaning [n -S]
WEAPONS	WEAPON, to supply with an instrument of offence or defence [v]
WEARIED	WEARY, to make tired (exhausted) [v]
WEARIER	WEARY, tired (exhausted) [adj]
WEARILY	in a weary manner [adv]
WEARISH	tasteless [adj]
WEATHER	to expose to atmospheric conditions [v -ED, -ING, -S]
WEBINAR	a seminar via the World Wide Web [n -S]
WEDGIER	WEDGY, resembling a wedge [adj]
WEEDING	the task of weeding [n -S]
WEENIER	WEENY, tiny (very small) [adj]
WEETING	WEETE, to detect, also WEETEN [v]
WEIGELA	a flowering shrub, also WEIGELIA [n -S]
WEIRDIE	a very strange person, also WEIRDO, WEIRDY [n -S]
WEIRING	WEIR, to guard (to protect (to shield from harm, attack or injury)) [v]
WELTING	a cord used to reinforce a seam [n -S]
WENDIGO	a mythical monster [n -S]
WENNIER	WENNY, resembling a wen, also WENNISH [adj]
WESTING	a shifting west [n -S]
WETLAND	marshy land [n -S]
WHEATEN	a pale yellowish colour [n -S]
WHEREAT	at what [adv]
WHEREIN	in which place [adv]
WIDENER	one that widens (to make wide (extending far)) [n -S]
WIDEOUT	a receiver in football [n -S]
WIDGEON	a river duck [n -S]
WIELDER	one who wields (to use, also WILD) [n -S]
WIENIES	WIENIE, a frankfurter, also WIENER [n]
WILDERS	WILDER, to cause to stray [v]
WILDEST	WILD, living in a natural state, also WIELD [adj]
WINDAGE	the influence of the wind in deflecting a missile [n -S]
WINDIER	WINDY, marked by strong wind [adj]
WINDLES	WINDLE, to wind (to twist or coil) [v]
WINDORE	a form of window [n -S]
WINESAP	a red apple with somewhat tart flesh [n -S]
WINESOP	a food sopped in wine [n -S]
WINGIER	WINGY, swift (speedy (swift)) [adj]
WINGLET	a small wing [n -S]
WINSOME	charming [adj WINSOMER, WINSOMEST]
WINTERY	having the characteristics of winter, also WINTRY, WINTERLY [adj WINTERIER, WINTERIEST]
WINTLED	WINTLE, to stagger (to walk or stand unsteadily) [v]
WIPEOUT	a fall from a surfboard [n -S]
WIRABLE	able to be wired [adj]
WIREMAN	one who makes or works with wire [n WIREMEN]
WIREMEN	WIREMAN, one who makes or works with wire [n]
WIRETAP	to intercept messages secretly with a device [v WIRETAPPED, WIRETAPPING, WIRETAPS]
WIRIEST	WIRY, resembling wire [adj]
WOMANED	WOMAN, to play the part of a woman [v]
WOMERAS	WOMERA, a stick used to propel spears, also WOMMERA, WOOMERA [n]
WONGIED	WONGI, to chat (to talk informally) [v]
WONKIER	WONKY, shaky (shaking) [adj]
WOODIER	WOODY, resembling wood [adj]
WOODIES	WOODY, a wood-panelled station wagon, also WOODIE [n]
WOOLIER	WOOLY, resembling wool, also WOOLLY, WOOLIE [adj]
WOOLIES	WOOLIE, a woollen garment, also WOOLLY, WOOLY [n]
WOORALI	a plant yielding curare, also WOORARA, WOORARI [n -S]
WORDAGE	the number of words used [n -S]
WORDIER	WORDY, using many words [adj]
WORRIED	WORRY, to cause to be anxious [v]
WORRIES	WORRY, to cause to be anxious [v]
WOUNDER	one that wounds (to inflict an injury upon) [n -S]
WOURALI	a plant which yields curare, also OURALI, URALI [n -S]
WRANGED	WRANG, to wrong (to treat unjustly) [v]
WRANGLE	to argue noisily [v WRANGLED, WRANGLING, WRANGLES]
WREATHE	to shape into a wreath, also WRETHE [v WREATHED, WREATHING, WREATHES]
WRINGED	WRING, to twist so as to compress [v]
WRITHEN	twisted [adj]
WRITTEN	WRITE, to form characters on a surface with an instrument [v]
WRONGED	WRONG, to treat unjustly [v]
WROOTED	WROOT, to turn up with the snout [v]
WURLIES	WURLIE, an Aborigine hut, also WURLEY [n]
XERAFIN	a former silver coin of Goa, also XERAPHIM [n -S]
XERASIA	dryness of the hair [n -S]
XEROTIC	of abnormally dry body tissues [adj]
YAWNIER	YAWNY, full of yawns [adj]
YEADING	YEAD, to go or proceed [v]
YEALDON	fuel, also ELDIN, EILDING, ELDING [n -S]
YEALING	a person of the same age [n -S]
YEANING	YEAN, to lamb (to give birth to baby sheep) [v]
YEAREND	the end of the year [n -S]
YEARNED	YEARN, to long for [v]
YEARNER	one who yearns (to long for) [n -S]
YEEDING	YEED, to go or proceed (pa t YOD, YODE), also YEDE [v]
YEELINS	YEELIN, an animal over one but not two, also YEARLING [n]
YERDING	YERD, to bury (to put in the ground and cover with earth) [v]
YIELDER	one who yields (to concede (to yield)) [n -S]
YODELER	one who yodels, also YODELLER [n -S]
YONNIES	YONNIE, (Australian slang) a stone, when thrown, also BRINNY [n]
YOUNGER	an inferior in age [n -S]
YPERITE	a poisonous gas [n -S]
YUGARIE	Queensland name for the pipi shellfish, also EUGARIE [n -S]
ZEBRANO	a tree having striped wood [n -S]
ZEBRINA	a creeping plant [n -S]
ZELATOR	a nun who oversees the behaviour of other nuns, also ZELATRIX [n -S]
ZENAIDA	a wild dove [n -S]
ZEOLITE	a mineral [n -S]
ZEROING	ZERO, to aim at the centre of a target [v]
ZINCATE	a chemical salt [n -S]
ZINGARO	an Italian gypsy, also ZINGANO [n ZINGARI]
ZOISITE	a mineral [n -S]
ZONATED	having zones [adj]
ZONULAE	ZONULA, a small zone, also ZONULE [n]
ZOOIEST	ZOOEY, like a zoo [adj]
ZOOLITE	a fossil animal, also ZOOLITH [n -S]
ZOONITE	a segment of an articulated animal [n -S]
ZOOTIER	ZOOTY, flashy in manner or style [adj]
ZORGITE	a metallic copper-lead selenide [n -S]
