ADAGIAL	relating to a traditional saying [adj]
ADAGIOS	ADAGIO, a slow musical composition [n]
ADENINE	an alkaloid (a type of chemical compound) [n -S]
ADNOUNS	ADNOUN, an adjective used as a noun [n]
ADORING	ADORE, to worship (to honour as a divine being) [v]
ADORNER	one who adorns (to embellish) [n -S]
ADRENAL	an endocrine gland [n -S]
ADULATE	to fawn upon [v ADULATED, ADULATING, ADULATES]
AEGISES	AEGIS, protection, also EGIS [n]
AENEOUS	of a shining bronze colour, also AENEUS [adj]
AEONIAN	eternal [adj]
AERATED	AERATE, to put air into [v]
AERATOR	one that aerates (to put air into) [n -S]
AEROGEL	a highly porous solid [n -S]
AERUGOS	AERUGO, a green film that forms on copper, also ERUGO [n]
AGAINST	opposite to [prep]
AGAROSE	a sugar obtained from agar [n -S]
AGATISE	to cause to resemble agate, also AGATIZE [v AGATISED, AGATISING, AGATISES]
AGATOID	resembling agate (a variety of quartz) [adj]
AGEISTS	AGEIST, an advocate of ageism (discrimination based on age, also AGISM) [n]
AGELAST	a non laughing person [n -S]
AGELESS	never growing old [adj]
AGENDAS	AGENDA, a list of things to be done [n]
AGENTED	AGENT, to act for another with authority [v]
AGEUSIA	lack of a sense of taste [n -S]
AGISTOR	person in charge of agisted cattle, also AGISTER [n -S]
AGITANS	as in paralysis agitans, Parkinson's disease [adj]
AGITATE	to stir violently [v AGITATED, AGITATING, AGITATES]
AGITATO	agitated (music) [adj]
AGNAILS	AGNAIL, a torn shred of skin beside the nail [n]
AGNATES	AGNATE, a relative on the father's side [n]
AGNOSIA	loss of ability to recognize familiar objects [n -S]
AGOUTAS	AGOUTA, a rare Haitian mammal that eats insects [n]
AGOUTIS	AGOUTI, a burrowing rodent, also ACOUCHI, ACOUCHY, AGOUTY, AGUTI [n]
AGRISES	AGRISE, to terrify, also AGRIZE, AGRYZE [v]
AGROUND	on the ground [adv]
AGUISED	AGUISE, to adorn, also AGUIZE [v]
AGUISES	AGUISE, to adorn, also AGUIZE [v]
AILANTO	an Asiatic tree [n -S]
AILETTE	a plate of armour for the shoulder [n -S]
AIRGUNS	AIRGUN, a gun that discharges missiles by means of compressed air [n]
AIRINGS	AIRING, an exposure to the air [n]
AIRNING	AIRN, to iron (to eliminate wrinkles from clothes by pressing) [v]
AIRTING	AIRT, to direct (to control or conduct the affairs of) [v]
AISLING	a vision [n -S]
ALANINE	an amino acid, also ALANIN [n -S]
ALANINS	ALANIN, an amino acid, also ALANINE [n]
ALASTOR	an avenging deity in Greek tragedy [n -S]
ALATION	the state of having wings [n -S]
ALDOSES	ALDOSE, a type of sugar [n]
ALDRINS	ALDRIN, an insecticide [n]
ALEGARS	ALEGAR, sour ale [n]
ALERTED	ALERT, to warn (to notify in advance) [v]
ALERTER	ALERT, ready for action [adj]
ALEURON	a protein found in some seeds, also ALEURONE [n -S]
ALGATES	always (every time) [adv]
ALGESES	ALGESIS, sensation of pain [n]
ALGESIA	sensitivity to pain [n -S]
ALGESIS	sensation of pain [n ALGESES]
ALIASES	ALIAS, an assumed name [n]
ALIENED	ALIEN, to transfer to another as property [v]
ALIENEE	one to whom property is transferred [n -S]
ALIGNED	ALIGN, to arrange in line [v]
ALINING	ALINE, to arrange in a straight line [v]
ALISONS	ALISON, a small flowering plant, sweet alyssum [n]
ALIUNDE	from another source [adv]
ALNAGER	cloth inspector, also AULNAGER [n -S]
ALNAGES	ALNAGE, cloth inspection, also AULNAGE [n]
ALOGIAS	ALOGIA, inability to speak [n]
ALONGST	along (onward (towards the front, also ONWARDS)) [adv]
ALTERED	ALTER, to make different [v]
ALTERER	one that alters (to make different) [n -S]
ALTESSE	highness, also ALTEZA, ALTEZZA [n -S]
ANALGIA	inability to feel pain [n -S]
ANALOGA	ANALOGON, analogue (something that bears a resemblance to something else, also ANALOG) [n]
ANALOGS	ANALOG, something that bears a resemblance to something else, also ANALOGUE [n]
ANATASE	a mineral [n -S]
ANATTAS	ANATTA, a yellowish red dye, also ACHIOTE, ANATTO, ANNATTA, ANNATTO, ROUCOU [n]
ANATTOS	ANATTO, a yellowish red dye, also ACHIOTE, ANATTA, ANNATTA, ANNATTO, ROUCOU [n]
ANDANTE	a moderately slow musical passage [n -S]
ANDIRON	a metal support for logs in a fireplace, also ENDIRON, FIREDOG [n -S]
ANEARED	ANEAR, to approach (to come near to) [v]
ANELING	ANELE, to anoint (to consecrate with oil) [v]
ANEURIN	vitamin B [n -S]
ANGARIA	the right of warring state to seize neutral property, also ANGARY [n -S]
ANGELED	ANGEL, to support financially [v]
ANGELUS	a call to prayer [n -ES]
ANGERED	ANGER, to irritate (to provoke (to arouse to anger or sexual desire)) [v]
ANGINAL	relating to angina [adj]
ANGINAS	ANGINA, a disease marked by spasmodic attacks of intense pain [n]
ANGLIST	an expert on English language or culture [n -S]
ANGORAS	ANGORA, the long silky hair of a domestic goat [n]
ANGUINE	like a snake [adj]
ANGULAR	having an angle [adj]
ANILINE	a chemical compound, also ANILIN [n -S]
ANILINS	ANILIN, a chemical compound, also ANILINE [n]
ANLAGEN	ANLAGE, the first discernible rudiment of an organ [n]
ANLAGES	ANLAGE, the first discernible rudiment of an organ [n]
ANLASES	ANLAS, a short dagger [n]
ANNATES	the first year's revenue of a bishop paid to the pope [n]
ANNATTA	a yellowish red dye, also ACHIOTE, ANATTA, ANATTO, ANNATTO, ROUCOU [n -S]
ANNATTO	a yellowish red dye, also ACHIOTE, ANATTA, ANATTO, ANNATTA, ROUCOU [n -S]
ANNEALS	ANNEAL, to toughen (to make tough (strong and resilient)) [v]
ANNELID	any of a phylum of segmented worms [n -S]
ANNUALS	ANNUAL, something that is produced yearly [n]
ANNULAR	the ring-finger [n -S]
ANNULET	a small ring [n -S]
ANOESES	ANOESIS, feeling without understanding [n]
ANTARAS	ANTARA, a type of Pan-pipes [n]
ANTEING	ANTE, to stake at poker [v]
ANTIAIR	directed against attacking aircraft [adj]
ANTIENT	an old man [n -S]
ANTIGEN	a substance that stimulates the production of antibodies, also ANTIGENE [n -S]
ANTIGUN	opposed to guns [adj]
ANTILOG	a number corresponding to a given logarithm [n -S]
ANTINGS	ANTING, the act of birds placing ants among their feathers [n]
ANTISAG	designed to prevent sagging [adj]
ANTLION	a predatory insect [n -S]
ANURANS	ANURAN, a toad or a frog [n]
ANURIAS	ANURIA, failure to urinate [n]
AORISTS	AORIST, a verb tense [n]
ARAISES	ARAISE, to raise, also ARAYSE [v]
ARALIAS	ARALIA, a plant of the ivy family [n]
ARDOURS	ARDOUR, passion of feeling, also ARDOR [n]
AREOLAE	AREOLA, a small space in a network of leaf veins, also AREOLE [n]
AREOLAR	pertaining to an areola (a small space in a network of leaf veins, also AREOLE) [adj]
ARETTED	ARET, to entrust, also ARETT [v]
ARGALAS	ARGALA, an Indian stork [n]
ARGALIS	ARGALI, the great wild sheep of Asia [n]
ARGANDS	ARGAND, a gas lamp named after its inventor [n]
ARGONON	an inert gas [n -S]
ARGUERS	ARGUER, one who argues (to discuss with reasoning) [n]
ARGUSES	ARGUS, an E Indian pheasant [n]
ARIOSOS	ARIOSO, a melody resembling an aria [n]
ARISING	ARISE, to come up [v]
ARISTAS	ARISTA, a bristlelike structure [n]
ARISTOS	ARISTO, an aristocrat [n]
ARNATTO	a yellowish-red dye [n -S]
ARNOTTO	a tropical tree [n -S]
AROUSAL	the act of arousing (to stimulate) [n -S]
AROUSER	one who arouses (to stimulate) [n -S]
AROUSES	AROUSE, to stimulate [v]
ARRAIGN	to put on trial [v -ED, -ING, -S]
ARRANGE	to put in order [v ARRANGED, ARRANGING, ARRANGES]
ARRASED	covered with arras [adj]
ARRASES	ARRAS, a rich tapestry [n]
ARREEDE	to declare, also AREAD, AREDE [v ARED or AREDD, ARREEDING, ARREEDES]
ARRESTS	ARREST, to bring to a standstill [v]
ARRIAGE	a feudal tax paid with beasts of burden [n -S]
ARRISES	ARRIS, a sharp edge where two surfaces meet [n]
ARTISTS	ARTIST, one who is skilled in art [n]
ARUGOLA	a European herb, also ARUGULA [n -S]
ASIAGOS	ASIAGO, an Italian cheese [n]
ASININE	idiotic (pertaining to an idiot (a mentally deficient person)) [adj]
ASSAGAI	to pierce with a light spear, also ASSEGAAI [v -ED, -ING, -S]
ASSAULT	to attack (to assault) [v -ED, -ING, -S]
ASSEGAI	to pierce with a light spear, also ASSAGAI [v -ED, -ING, -S]
ASSIEGE	to besiege (to attack and surround, also SIEGE) [v ASSIEGED, ASSIEGING, ASSIEGES]
ASSUAGE	to make less severe, also ASSWAGE [v ASSUAGED, ASSUAGING, ASSUAGES]
ASSURED	an insured person [n -S]
ASSURER	one who assures (to insure (to secure payment in the event of loss of damage)) [n -S]
ASSUROR	one who assures (to insure (to secure payment in the event of loss of damage)) [n -S]
ASTARTS	ASTART, to start up, also ASTERT [v]
ASTASIA	inability to stand [n -S]
ASTERTS	ASTERT, to start up, also ASTART [v]
ASTOUND	to amaze (to overwhelm with astonishment) [v -ED, -ING, -S]
ASTRALS	ASTRAL, a type of oil lamp [n]
ASTRAND	on the strand [adv]
ASTROID	a four cusped geometrical figure [n -S]
ASTUTER	ASTUTE, shrewd and perceptive [adj]
ATLASES	ATLAS, a column in the form of a man [n]
ATONING	ATONE, to make amends [v]
ATTAINS	ATTAIN, to gain by effort (exertion (the act of exerting (exert))) [v]
ATTONED	ATTONE, to atone (to make amends) [v]
ATTUNED	ATTUNE, to put in tune [v]
ATTUNES	ATTUNE, to put in tune [v]
AUDINGS	AUDING, hearing, recognizing and interpreting a language [n]
AUDITEE	one that is audited [n -S]
AUDITOR	one who audits (to examine accounts) [n -S]
AUGENDS	AUGEND, a number to which another is to added [n]
AUGITES	AUGITE, a mineral [n]
AULDEST	AULD, old (living for a long time) [adj]
AULNAGE	cloth inspection, also ALNAGE [n -S]
AURATED	gold-coloured [adj]
AURATES	AURATE, a salt containing gold [n]
AUREATE	golden (of the colour of gold) [adj]
AURELIA	a jellyfish [n -S]
AUREOLA	a halo [n AUREOLAS or AUREOLAE]
AUREOLE	to surround with a halo [v AUREOLED, AUREOLING, AUREOLES]
AURISTS	AURIST, an ear specialist [n]
AURORAE	AURORA, the dawn [n]
AURORAL	relating to the dawn, also AUROREAN [adj]
AURORAS	AURORA, the dawn [n]
AUSTRAL	a unit of currency in Argentina [n AUSTRALS or AUSTRALES]
AUTISTS	AUTIST, an autistic (one who suffers from autism) [n]
AUTOING	AUTO, to ride in an automobile [v]
DAINING	DAINE, to condescend, also DEIGN [v]
DAISIES	DAISY, a flowering plant [n]
DALASIS	DALASI, a unit of Gambian currency [n]
DALTONS	DALTON, a unit of atomic mass [n]
DANGLER	one that dangles (to hang loosely) [n -S]
DANGLES	DANGLE, to hang loosely [v]
DANTING	DANT, to frighten, also DAUNT [v]
DANTONS	DANTON, to dare, also DAUNTON [v]
DARGLES	DARGLE, a dell (a small wooded valley, also DINGLE) [n]
DARINGS	DARING, bravery (courage (the quality that enables people to be brave)) [n]
DARLING	a much loved person, also DEARLING [n -S]
DARNING	things to be darned [n -S]
DARRAIN	to justify, also DARRAIGN, DARRAINE, DARRAYN [v -ED, -ING, -S]
DARRING	DARRE, to venture boldly, also DARE, DAUR [v]
DARTING	DART, to move suddenly and swiftly [v]
DATARIA	an officer who attends to papal bulls, also DATARY [n -S]
DATINGS	DATING, a determination of a date in time [n]
DATURAS	DATURA, a flowering plant [n]
DAUNTER	one that daunts (to frighten, also DANT) [n -S]
DAUNTON	to dare, also DANTON [v -ED, -ING, -S]
DAURING	DAUR, to venture boldly, also DARE, DARRE [v]
DAUTING	DAUT, to fondle, also DAWT [v]
DEALATE	an insect divested of its wings [n -S]
DEALING	a business transaction [n -S]
DEANING	DEAN, to serve as the head of faculty [v]
DEERLET	a mouse deer [n -S]
DEGASES	DEGAS, to remove gas from [v]
DEGAUSS	to demagnetize [v -ED, -ING, -ES]
DEGOUTS	DEGOUT, distaste [n]
DEGREES	DEGREE, a graduation on a scale [n]
DEGUSTS	DEGUST, to taste with pleasure [v]
DEITIES	DEITY, a god or goddess [n]
DELAINE	a wool fabric [n -S]
DELATOR	one that delates (to accuse (to bring a charge against)) [n -S]
DELEING	DELE, to delete (to remove printed matter) [v]
DELETES	DELETE, to remove printed matter [v]
DELISTS	DELIST, to remove from a list [v]
DELOUSE	to free from lice [v DELOUSED, DELOUSING, DELOUSES]
DELUGES	DELUGE, to flood (to inundate (to fill with overflowing abundance)) [v]
DENGUES	DENGUE, a tropical disease [n]
DENNETS	DENNET, a nineteenth century horse gig [n]
DENOTES	DENOTE, to indicate (to point out) [v]
DENSEST	DENSE, compact (closely fitted together) [adj]
DENTATE	having teeth, also DENTATED [adj]
DENTELS	DENTEL, one of a row of tooth-shaped square blocks, also DENTIL [n]
DENTINE	the hard substance forming the body of a tooth, also DENTIN [n -S]
DENTING	DENT, to make a depression in [v]
DENTURE	a set of teeth [n -S]
DERANGE	to disorder (to disarrange) [v DERANGED, DERANGING, DERANGES]
DERNIER	last [adj]
DESALTS	DESALT, to remove the salt from [v]
DESERTS	DESERT, to abandon (to desert) [v]
DESIGNS	DESIGN, to plan in outline, also DESINE, DESYNE [v]
DESINES	DESINE, to plan in outline, also DESIGN, DESYNE [v]
DESSERT	a final course of a meal [n -S]
DESUGAR	to remove the sugar from [v -ED, -ING, -S]
DETENTE	an easing of international tension [n -S]
DETENTS	DETENT, a locking or unlocking mechanism [n]
DETENUE	a female prisoner (one that is imprisoned) [n -S]
DETENUS	DETENU, a prisoner (one that is imprisoned) [n]
DETERGE	to cleanse (to clean (to rid of stain)) [v DETERGED, DETERGING, DETERGES]
DETESTS	DETEST, to hate intensely [v]
DETINUE	action to recover property wrongfully detained [n -S]
DETUNES	DETUNE, to reduce the power of a car engine [v]
DEUTONS	DEUTON, the nucleus of heavy hydrogen, also DEUTERON [n]
DIALING	the art of making sundials [n -S]
DIALIST	a dialer, also DIALLIST [n -S]
DIALOGS	DIALOG, to converse (to speak together) [v]
DIANOIA	(philosophy) a lower mode of knowledge from perception and experience [n -S]
DIARIAL	of a diarchy [adj]
DIARIAN	of a diarchy [adj]
DIARIST	one who keeps a diary [n -S]
DIATRON	a circuitry design that uses diodes [n -S]
DIESELS	DIESEL, to continue running after ignition is turned off [v]
DIETINE	a minor Japanese parliament [n -S]
DIETING	the act of dieting [n -S]
DIETIST	an authority on diets [n -S]
DIGESTS	DIGEST, to assimilate food in the stomach, also DISGEST [v]
DIGITAL	a piano key [n -S]
DIGLOTS	DIGLOT, a bilingual book [n]
DIGONAL	having half-turn symmetry [adj]
DIGRESS	to stray from the main topic [v -ED, -ING, -ES]
DILATOR	one that dilates (to make larger (large)) [n -S]
DILUENT	a diluting substance [n -S]
DILUTEE	an unskilled worker employed in a skilled area [n -S]
DILUTER	one that dilutes, also DILUTOR [n -S]
DILUTES	DILUTE, to make thinner [v]
DILUTOR	one that dilutes, also DILUTER [n -S]
DINETTE	a small dining room [n -S]
DINGIER	DINGY, grimy, also DINGEY [adj]
DINGIES	DINGY, to ignore or avoid [v]
DINGLES	DINGLE, a small wooded valley, also DELL [n]
DINITRO	having two nitro groups [adj]
DINNLES	DINNLE, to shake (to move to and fro with short, rapid movements) [v]
DINTING	DINT, to dent (to make a depression in) [v]
DIORITE	an igneous rock [n -S]
DIRIGES	DIRIGE, a dirge (a funeral song) [n]
DIRLING	DIRL, to tremble (to shake (to move to and fro with short, rapid movements)) [v]
DIRTIER	DIRTY, soiled [adj]
DIRTING	DIRT, to dirty (to soil (to make dirty)) [v]
DISEASE	to make unhealthy [v DISEASED, DISEASING, DISEASES]
DISEURS	DISEUR, an entertainer [n]
DISEUSE	a female entertainer [n -S]
DISGEST	to assimilate food in the stomach, also DIGEST [v -ED, -ING, -S]
DISGUST	to cause loathing [v -ED, -ING, -S]
DISROOT	to uproot (to pull up by the roots) [v -ED, -ING, -S]
DISSING	DIS, to disparage, also DISS [v]
DISTAIN	to stain (to discolour) [v -ED, -ING, -S]
DISTANT	far off or apart [adj]
DISTILS	DISTIL, to extract by vaporization and condensation, also DISTILL [v]
DISTORT	to twist or bend out of shape [v -ED, -ING, -S]
DITTIES	DITTY, to put to music [v]
DITTING	DIT, to block (to obstruct (to get in the way of)) [v]
DIURNAL	a diary (a personal journal) [n -S]
DIURONS	DIURON, a herbicide [n]
DOATING	an excessive love, also DOTING [n -S]
DOGEATE	the office of a doge, also DOGESHIP, DOGATE [n -S]
DOGTROT	to move at a steady trot [v DOGTROTTED, DOGTROTTING, DOGTROTS]
DOILTER	DOILT, crazy (insane (mentally unsound)) [adj]
DOLENTE	musical direction, to be performed in a sorrowful manner [adj]
DOLINAS	DOLINA, a swallow-hole, also DOLINE [n]
DOLOSSE	DOLOS, a big spiky concrete block in the shape of a twisted H. Many of these tangle well to form a breakwater [n]
DOLOURS	DOLOUR, grief, also DOLOR [n]
DONATOR	one that donates, also DONOR [n -S]
DONGLES	DONGLE, a device for defeating software piracy [n]
DONGOLA	a type of leather [n -S]
DONINGS	DONING, the act of donating (to contribute) [n]
DONNART	stupid, dazed, also DONNARD, DONNERD, DONNERED, DONNERT [adj]
DONNATS	DONNAT, an idler, also DONNOT [n]
DONNEES	DONNEE, assumptions upon which a story is founded [n]
DONNERT	stupid, dazed, also DONNARD, DONNART, DONNERD, DONNERED [adj]
DONNIES	DONNY, the hand, also DANNY [n]
DONNOTS	DONNOT, an idler, also DONNAT [n]
DOOLANS	DOOLAN, (New Zealand) a Roman Catholic [n]
DOOLEES	DOOLEE, a stretcher for the sick, also DOOLIE, DOOLY [n]
DOOSRAS	DOOSRA, a certain bowling action in cricket [n]
DORRING	DOR, to mock (to ridicule (to make fun of)) [v]
DORSALS	DORSAL, a fin on the back [n]
DORSELS	DORSEL, an ornamental cloth hung behind an altar, also DOSSAL, DOSSEL [n]
DORSERS	DORSER, a basket carrier on the back, also DOSSER [n]
DORTIER	DORTY, delicate [adj]
DORTING	DORT, to sulk (to become sullen and aloof) [v]
DORTOUR	a dormitory, also DORTER [n -S]
DOSAGES	DOSAGE, a measure of medicine [n]
DOSSING	DOSS, to sleep in any convenient place [v]
DOTANTS	DOTANT, someone who dotes, also DOTARD [n]
DOTINGS	DOTING, an excessive love, also DOATING [n]
DOTTELS	DOTTEL, a mass of half-burnt pipe tobacco, also DOTTLE [n]
DOTTIER	DOTTY, crazy (insane (mentally unsound)) [adj]
DOTTING	DOT, to cover with tiny round marks [v]
DOTTLER	DOTTLE, of tobacco, partly burnt [adj]
DOTTLES	DOTTLE, a mass of partly burnt pipe tobacco, also DOTTEL [n]
DOTTREL	a shore bird, also DOTTEREL [n -S]
DOUANES	DOUANE, a custom-house [n]
DOULEIA	veneration of saints and angels [n -S]
DOURINE	a disease of horses [n -S]
DOUSERS	DOUSER, one that douses (to plunge into water) [n]
DOUSING	DOUSE, to plunge into water [v]
DOUTING	DOUT, to extinguish [v]
DRAGEES	DRAGEE, a sugarcoated candy [n]
DRAGONS	DRAGON, a mythical, serpentlike monster [n]
DRAGOON	to harass by the use of troops [v -ED, -ING, -S]
DRAUNTS	DRAUNT, to drone (to make a monotonous humming sound) [v]
DREARES	DREARE, gloom, also DREAR, DRERE [n]
DREEING	DREE, to suffer (to feel pain or distress) [v]
DRESSER	one that dresses (to clothe (to provide with clothing)) [n -S]
DROGERS	DROGER, a West Indian sailing vessel, also DROGHER [n]
DROGUES	DROGUE, a sea anchor [n]
DROGUET	a ribbed woollen dress fabric [n -S]
DRONGOS	DRONGO, a no-hoper [n]
DRONIER	DRONY, monotonous [adj]
DRONING	DRONE, to make a monotonous humming sound [v]
DRUSIER	DRUSY, rough with minute crystals [adj]
DUALINS	DUALIN, a type of explosive mixture [n]
DUALIST	an adherent of dualism (a philosophical theory) [n -S]
DUELERS	DUELER, one who duels, also DUELIST, DUELLER, DUELLIST [n]
DUELING	DUEL, to fight formally [v]
DUELIST	one who duels, also DUELER, DUELLER, DUELLIST [n -S]
DUENESS	the state of being owed [n -ES]
DUENNAS	DUENNA, a governess [n]
DUETING	DUET, to perform a duet [v]
DUETTOS	DUETTO, a musical performance by two people, also DUET, DUETT [n]
DUGITES	DUGITE, an Australian venomous snake [n]
DULNESS	the state of being dull, also DULLNESS [n -ES]
DULOSES	DULOSIS, enslavement by an insect [n]
DULOSIS	enslavement by an insect [n DULOSES]
DUNGEON	to confine in an underground prison [v -ED, -ING, -S]
DUNGERS	DUNGER, (New Zealand) a dilapidated car or machine [n]
DUNGIER	DUNGY, filthy (offensively dirty) [adj]
DUNLINS	DUNLIN, a wading bird [n]
DUNNAGE	packing material used to protect cargo [n -S]
DUNNART	an Australian marsupial mouse [n -S]
DUNNESS	the state of being dun (of a dull brown colour) [n -ES]
DUNNEST	DUN, of a dull brown colour [adj]
DUNNIER	DUNNY, stupid, also DONNIKER, DUNNAKIN [adj]
DUNNIES	DUNNY, an outside lavatory [n]
DUNNITE	an explosive [n -S]
DUNTING	DUNT, to strike with a heavy blow [v]
DUOLOGS	DUOLOG, a conversation between two people, also DUOLOGUE [n]
DUOTONE	an illustration in two tones [n -S]
DURANTS	DURANT, a type of strong cloth [n]
DURESSE	compulsion by force, also DURESS [n -S]
DURGANS	DURGAN, a dwarf (an extremely small person) [n]
DURGIER	DURGY, dwarfish (resembling a dwarf (an extremely small person)) [adj]
DURIANS	DURIAN, an East Indian tree, also DURION [n]
DURIONS	DURION, an East Indian tree, also DURIAN [n]
DURNING	DURN, to damn (to curse (to invoke evil upon)) [v]
DURRIES	DURRIE, an Indian cotton rug, also DHURRIE [n]
DUSTERS	DUSTER, one that dusts (to rid of minute particles of matter) [n]
DUSTING	a light sprinkling [n -S]
DUSTRAG	a rag used for dusting [n -S]
EAGERER	EAGER, full of keen desire, also EAGRE, EGER [adj]
EAGLETS	EAGLET, a young eagle [n]
EANLING	the young of a sheep of goat [n -S]
EARLIER	EARLY, before the due time [adj]
EASELED	mounted on an easel [adj]
EASIEST	EASY, not difficult [adj]
EATAGES	EATAGE, horse fodder [n]
EDENTAL	belonging to a toothless order of mammals [adj]
EDGIEST	EDGY, tense (taut (fully stretched)) [adj]
EDITING	the act of editing [n -S]
EDITION	the number of copies printed at the one time [n -S] / to produce multiple copies of an art work [v -ED, -ING, -S]
EGALITE	the state of being equal, also EQUALITY, EGALITY [n -S]
EGESTED	EGEST, to discharge from the body [v]
EGOISTS	EGOIST, one who practices egoism (self-interest) [n]
EGOLESS	not self-centered [adj]
EGOTISE	to talk about oneself a lot, also EGOTIZE [v EGOTISED, EGOTISING, EGOTISES]
EGOTIST	a conceited person [n -S]
EIDOLON	a phantom (something existing in appearance only) [n EIDOLONS or EIDOLA]
EILDING	fuel, also ELDIN, ELDING, YEALDON [n -S]
ELDINGS	ELDING, fuel, also ELDIN, EILDING, YEALDON [n]
ELDRESS	a female church elder [n -ES]
ELEGANT	having fastidious taste [adj]
ELEGIES	ELEGY, a mournful poem for the dead [n]
ELEGISE	to write an elegy, also ELEGIZE [v ELEGISED, ELEGISING, ELEGISES]
ELIDING	ELIDE, to omit (to leave out) [v]
ELITIST	an adherent of elitism (belief in rule by an elite) [n -S]
ELODEAS	ELODEA, an aquatic herb [n]
ELOGIES	ELOGY, a funeral oration, also ELOGE, ELOGIUM [n]
ELOINED	ELOIN, to remove to a distant place, also ELOIGN, ESLOIN, ESLOYNE [v]
ELUATES	ELUATE, liquid obtained by eluting [n]
ELUDERS	ELUDER, one that eludes (to evade (to escape or avoid by cunning)) [n]
ELUDING	ELUDE, to evade (to escape or avoid by cunning) [v]
ELUENTS	ELUENT, a solvent, also ELUANT [n]
ELUTING	ELUTE, to remove by means of a solvent [v]
ENDERON	the sensitive layer of the skin [n -S]
ENDGATE	(N. Amer.) a tailboard [n -S]
ENDINGS	ENDING, termination [n]
ENDIRON	a metal support for logs in a fireplace, also ANDIRON, FIREDOG [n -S]
ENDLANG	lengthwise, also ENDLONG [adv]
ENDLESS	eternal [adj]
ENDLONG	lengthwise, also ENDLANG [adv]
ENDNOTE	a note placed at the end of the text [n -S]
ENDOGEN	a plant which grows from within [n -S]
ENDUING	ENDUE, to provide with, also INDEW, INDUE [v]
ENDURER	one that lasts (to continue (to go on with)) [n -S]
ENDURES	ENDURE, to last (to continue (to go on with)) [v]
ENERGID	a protoplasmic unit [n -S]
ENGILDS	ENGILD, to adorn with lustre [v]
ENGINED	ENGINE, to equip with machinery [v]
ENGINER	an engineer [n -S]
ENGINES	ENGINE, to equip with machinery [v]
ENGLUTS	ENGLUT, to swallow (to take into the stomach through the mouth and gullet) [v]
ENGORED	ENGORE, to gore (to pierce with a horn or tusk) [v]
ENGORES	ENGORE, to gore (to pierce with a horn or tusk) [v]
ENGROSS	to completely absorb one's attention, also INGROSS [v -ED, -ING, -ES]
ENGUARD	to guard (to protect (to shield from harm, attack or injury)) [v -ED, -ING, -S]
ENISLED	ENISLE, to put onto an island, also INISLE [v]
ENISLES	ENISLE, to put onto an island, also INISLE [v]
ENLARGE	to make larger, also ENLARGEN [v ENLARGED, ENLARGING, ENLARGES]
ENNAGES	ENNAGE, a measurement of printing type in ens [n]
ENNEADS	ENNEAD, a group of nine [n]
ENNUIED	ENNUI, to bore (to pierce with a tool) [v]
ENRAGED	ENRAGE, to make angry (feeling hostility) [v]
ENRANGE	to arrange, also ENRAUNGE [v ENRANGED, ENRANGING, ENRANGES]
ENROUND	to surround (to encompass) [v -ED, -ING, -S]
ENSEALS	ENSEAL, to put a seal upon [v]
ENSIGNS	ENSIGN, to mark with a badge or sign [v]
ENSILED	ENSILE, to store in a silo, also ENSILAGE [v]
ENSILES	ENSILE, to store in a silo, also ENSILAGE [v]
ENSOULS	ENSOUL, to infuse with a soul, also INSOUL [v]
ENSUING	ENSUE, to follow, also ENSEW [v]
ENSURED	ENSURE, to make sure (free from doubt) [v]
ENSURER	one that ensures (to make sure (free from doubt)) [n -S]
ENSURES	ENSURE, to make sure (free from doubt) [v]
ENTENTE	a friendly understanding between states [n -S]
ENTERED	ENTER, to go or come in [v]
ENTERER	someone who enters [n -S]
ENTERON	the alimentary canal (one [n ENTERONS or ENTERA]
ENTETEE	infatuated (feminine form) [adj]
ENTITLE	to give a right to, also INTITLE, INTITULE [v ENTITLED, ENTITLING, ENTITLES]
ENTRANT	someone who enters, also INTRANT [n -S]
ENTROLD	ENROLL, to insert on a register (pa p ENTROLD), also ENROL [v]
ENURING	ENURE, to accustom (to make familiar) [v]
ENURNED	ENURN, to put into an urn, also INURN [v]
EOSINES	EOSINE, a red dye, also EOSIN [n]
ERASERS	ERASER, one that erases (to efface or rub out) [n]
ERASURE	the act of erasing (to efface or rub out) [n -S]
ERELONG	soon (in the near future) [adv]
ERODENT	a caustic chemical [n -S]
ERODING	ERODE, to wear away [v]
ERRATAS	ERRATA, a list of printing errors [n]
ERUDITE	a learned person [n -S]
ESTATES	ESTATE, to bestow landed property [v]
ESTROUS	pertaining to estrus, also ESTRAL, OESTRAL, OESTROUS, ESTRUAL [adj]
ETAGERE	a display stand [n -S]
ETALAGE	a shop window display [n -S]
ETOURDI	thoughtless [adj]
ETRENNE	a New Year's gift [n -S]
ETTLING	ETTLE, to intend (to have as one's aim or purpose) [v]
EUGARIE	Queensland name for the pipi shellfish, also YUGARIE [n -S]
EUGENIA	a tropical evergreen tree [n -S]
EUGENOL	an aromatic liquid [n -S]
EUGLENA	a freshwater protozoan [n -S]
EULOGIA	holy bread [n EULOGIAE] / a blessing (a wish for success) [n -S]
EUSTELE	a plant part [n -S]
GADROON	to decorate with moulding bands [v -ED, -ING, -S]
GALATEA	a strong cotton fabric [n -S]
GALEATE	helmet-shaped (in anatomy) [adj]
GALENAS	GALENA, the principal ore of lead, also GALENITE [n]
GALETTE	a cake [n -S]
GALOOTS	GALOOT, an awkward or uncouth person, also GALLOOT [n]
GANNETS	GANNET, a large sea bird, also SOLAN [n]
GANOIDS	GANOID, a type of fish [n]
GANOINE	the outer hard layer on some fish scales, also GANOIN [n -S]
GANOINS	GANOIN, the outer hard layer on some fish scales, also GANOINE [n]
GANTLET	to overlap railway tracks, also GAUNTLET [v -ED, -ING, -S]
GARDANT	a guardian, also GUARDANT [n -S]
GARIALS	GARIAL, an Indian crocodile, also GAVIAL, GHARIAL [n]
GARLAND	to deck with wreaths of flowers [v -ED, -ING, -S]
GARNERS	GARNER, to gather and store [v]
GAROTED	GAROTE, to execute by strangling, also GARROTE, GAROTTE, GARROTTE [v]
GAROTTE	to execute by strangling, also GARROTE, GAROTE, GARROTTE [v GAROTTED, GAROTTING, GAROTTES]
GARRANS	GARRAN, a small sturdy horse, also GARRON [n]
GARRONS	GARRON, a small sturdy horse, also GARRAN [n]
GARROTE	to execute by strangling, also GAROTE, GAROTTE, GARROTTE [v GARROTED, GARROTING, GARROTES]
GARROTS	GARROT, a duck [n]
GARUDAS	GARUDA, a Hindu demigod [n]
GASEOUS	pertaining to gas [adj]
GASSIER	GASSY, containing gas [adj]
GASTRAL	pertaining to the stomach [adj]
GATEAUS	GATEAU, a rich layer cake [n]
GAUDIER	GAUDY, tastelessly showy [adj]
GAUDIES	GAUDY, a festival (a time of celebration) [n]
GAULTER	a gault digger [n -S]
GAUNTED	GAUNT, to yawn (to open the mouth in a large gape) [v]
GEALOUS	resentful of another's advantages, also JEALOUS [adj]
GELADAS	GELADA, a baboon (a large ape) [n]
GELANDE	as in gelande jump, a jump made in downhill skiing [adj]
GELATED	GELATE, to gel (to become like a jelly) [v]
GELATES	GELATE, to gel (to become like a jelly) [v]
GELDERS	GELDER, one that gelds (to castrate (to remove the testes of)) [n]
GELIDER	GELID, icy (covered with ice) [adj]
GENDERS	GENDER, to engender (to beget (to produce (to bring into existence))) [v]
GENERAL	a military officer [n -S]
GENESES	GENESIS, an origin (first existence) [n]
GENESIS	an origin (first existence) [n GENESES]
GENETTE	a carnivorous mammal, also GENET [n -S]
GENNELS	GENNEL, a narrow alley, also GINNEL [n]
GENNETS	GENNET, a small Spanish horse [n]
GENNIES	GENNY, a large triangular sail, also GENOA [n]
GENTEEL	well-bred or refined [adj GENTEELER, GENTEELEST]
GENTIAN	a flowering plant [n -S]
GENTILE	a non-Jewish person [n -S]
GENTLED	GENTLE, to tame (to subdue (to bring under control, also SUBDEW)) [v]
GENTLER	GENTLE, mild (gentle in temper and disposition) [adj]
GENTLES	GENTLE, to tame (to subdue (to bring under control, also SUBDEW)) [v]
GENTOOS	GENTOO, a Falkland Island penguin [n]
GENUINE	authentic [adj]
GENUSES	GENUS, a kind, sort or class [n]
GEOIDAL	pertaining to a geoid (a hypothetical surface of the earth) [adj]
GERUNDS	GERUND, a verbal noun [n]
GESSOED	having gesso as a coating or as a constituent part [adj]
GESTALT	a unified whole [n GESTALTS or GESTALTEN]
GESTANT	laden [adj]
GESTATE	to carry in the uterus during pregnancy [v GESTATED, GESTATING, GESTATES]
GESTURE	to express by bodily motion [v GESTURED, GESTURING, GESTURES]
GETTERS	GETTER, to purify with a chemically active substance [v]
GIAOURS	GIAOUR, a non-Muslim [n]
GIARDIA	a protozoan inhabiting the intestines [n -S]
GILDERS	GILDER, one that gilds (to cover with a thin layer of gold) [n]
GINNELS	GINNEL, a narrow alley, also GENNEL [n]
GINNIER	GINNY, affected with gin (a strong liquor) [adj]
GIRASOL	a variety of opal, also GIRASOLE, GIROSOL [n -S]
GIRDERS	GIRDER, a horizontal support [n]
GIRDLER	one that girdles (to encircle with a belt) [n -S]
GIRDLES	GIRDLE, to encircle with a belt [v]
GIRLIER	GIRLY, like a girl [adj]
GIRLIES	GIRLIE, a girl, also GIRLY [n]
GIRLOND	a garland [n -S]
GIRNIER	GIRNIE, ill-tempered [adj]
GIROSOL	a variety of opal, also GIRASOL, GIRASOLE [n -S]
GITANAS	GITANA, a female gypsy [n]
GITTERN	to play a medieval guitar [v -ED, -ING, -S]
GIUSTED	GIUST, to joust (to engage in personal combat, also JUST) [v]
GLADIUS	a sword (a weapon with a long blade) [n -ES]
GLAIRIN	organic matter in mineral waters [n -S]
GLANDES	GLANS, the tip of the penis or clitoris [n]
GLARIER	GLARY, glaring [adj]
GLASSED	GLASS, to encase in glass (a transparent material) [v]
GLASSEN	like glass [adj]
GLASSIE	a type of playing marble [n -S]
GLEANED	GLEAN, to gather little by little [v]
GLEANER	one that gleans (to gather little by little) [n -S]
GLEENIE	(English dialect) a guinea fowl [n -S]
GLEETED	GLEET, to discharge mucus from the urethra [v]
GLENOID	a socket shape [n -S]
GLENTED	GLENT, to glint (to glitter (to sparkle (to reflect flashes of light))) [v]
GLIADIN	a simple protein, also GLIADINE [n -S]
GLIDERS	GLIDER, a type of aircraft (a machine for travelling in the air) [n]
GLINTED	GLINT, to glitter (to sparkle (to reflect flashes of light)) [v]
GLIOSES	GLIOSIS, excessive growth [n]
GLIOSIS	excessive growth [n GLIOSES]
GLITTER	to sparkle (to reflect flashes of light) [v -ED, -ING, -S]
GLOATED	GLOAT, to regard with great or excessive satisfaction [v]
GLOATER	one that gloats (to regard with great or excessive satisfaction) [n -S]
GLONOIN	nitroglycerin [n -S]
GLORIAS	GLORIA, a halo [n]
GLORIED	GLORY, to rejoice proudly [v]
GLOSSAE	GLOSSA, the tongue [n]
GLOSSED	GLOSS, to make lustrous (reflecting light evenly and efficiently) [v]
GLOSSER	one that glosses (to make lustrous (reflecting light evenly and efficiently)) [n -S]
GLOTTIS	the opening between the vocal chords [n GLOTTISES or GLOTTIDES]
GLOUTED	GLOUT, to scowl (to frown angrily) [v]
GLUIEST	GLUEY, resembling glue [adj]
GLUTAEI	GLUTAEUS, a hip muscle [n]
GLUTENS	GLUTEN, a tough elastic plant protein substance [n]
GLUTTED	GLUT, to feed or fill to excess [v]
GLUTTON	a person who feeds to excess [n -S]
GNARLED	GNARL, to twist into a state of deformity [v]
GNARRED	GNAR, to snarl, also GNARR, KNAR [v]
GOANNAS	GOANNA, a large monitor lizard [n]
GOATEED	having a goatee [adj]
GOATEES	GOATEE, a small pointed beard [n]
GOATIER	GOATY, like a goat [adj]
GODETIA	a plant [n -S]
GODLESS	worshipping no god [adj]
GODLIER	GODLY, pious (marked by religious reverence) [adj]
GODSLOT	a slot in a television schedule for religious broadcasts [n -S]
GODSONS	GODSON, a male godchild (one whom a person sponsors at baptism) [n]
GOETIES	GOETY, black magic [n]
GOITRED	afflicted with a goiter, also GOITERED [adj]
GOLDARN	an expression of anger, also GOLDURN [n -S]
GOLDENS	GOLDEN, to become golden [v]
GOLDEST	GOLD, of the colour of gold [adj]
GOLDIER	GOLDY, similar to gold [adj]
GOLDURN	an expression of anger, also GOLDARN [n -S]
GOLIARD	a medieval student who indulged in goliardy [n -S]
GONADAL	pertaining to the gonad, also GONADIAL, GONADIC [adj]
GONDOLA	a long narrow boat [n -S]
GONIDIA	GONIDIUM, an asexual reproductive cell [n]
GOODIER	GOOD, having positive or desirable properties [adj]
GOODIES	GOODY, a desirable thing [n]
GOOIEST	GOOEY, sticky or viscid [adj]
GOOLIES	GOOLIE, a small stone, also GOOLY, GOOLEY [n]
GOONDAS	GOONDA, a hired thug [n]
GOONIER	GOONY, stupid, also GOONEY, GOONIE [adj]
GOORALS	GOORAL, a goat antelope, also GORAL [n]
GOORIES	GOORY, (New Zealand) a mongrel, an extinct native dog, also GOORIE, KURI [n]
GOOSIER	GOOSY, resembling a goose, also GOOSEY [adj]
GOOSIES	GOOSY, a goose (a swimming bird) [n]
GORDITA	a stuffed and fried pocket of cornmeal dough [n -S]
GORSIER	GORSY, abounding in gorse (furze (a spiny shrub, also WHIN)) [adj]
GOSLETS	GOSLET, a dwarf goose [n]
GOSTERS	GOSTER, (English dialect) to laugh uncontrollably [v]
GOURDES	GOURDE, a monetary unit of Haiti [n]
GOUTIER	GOUTY, affected with gout [adj]
GOUTTES	GOUTTE, a drop [n]
GRADATE	to change by degrees [v GRADATED, GRADATING, GRADATES]
GRADERS	GRADER, one that grades (to arrange in steps or degrees) [n]
GRADINI	of GRADINO [n pl. pl]
GRADINO	a decoration for a gradin [n pl.]
GRADINS	GRADIN, one of a series of steps, also GRADINE [n]
GRADUAL	a hymn sung in alternate parts [n -S]
GRANDEE	a man of high rank [n -S]
GRANDER	GRANDE, grand (large and impressive) [adj]
GRANITA	an ice confection typically made from fruit [n -S]
GRANOLA	a breakfast cereal [n -S]
GRANTOR	one that grants, also GRANTER [n -S]
GRANULE	a small particle (a very small piece or part) [n -S]
GRASSED	GRASS, to cover with grass (herbaceous plants) [v]
GRASSER	an informer (one who informs (to pass on information, also ENFORM)) [n -S]
GREASED	GREASE, to smear with grease (a lubricant) [v]
GREASER	one that greases (to smear with grease (a lubricant)) [n -S]
GREASES	GREASE, to smear with grease (a lubricant) [v]
GREATER	GREAT, large (great in size) [adj]
GREENED	GREEN, to become green [v]
GREENER	an immigrant [n -S]
GREENIE	an environmentalist [n -S]
GREESES	GREESE, a step, also GRECE, GRECIAN, GREECE, GREESING, GRESE, GRESSING, GRIECE, GRIZE [n]
GREETED	GREET, to address courteously on meeting [v]
GREETER	one that greets (to address courteously on meeting) [n -S]
GREETES	GREETE, to weep (to shed tears (salty liquid) from the eyes) [v]
GREINED	GREIN, to long (to yearn for) [v]
GRENADE	an explosive device [n -S]
GRENNED	GREN, to grin (to smile broadly, also GERNE) [v]
GRIESIE	grim, also GRISY, GRIESY, GRYESY, GRYSIE [adj]
GRILSES	GRILSE, a young salmon [n]
GRINDER	one that grinds (to wear, smooth or sharpen by friction) [n -S]
GRINNED	GRIN, to smile broadly, also GERNE [v]
GRINNER	one that grins (to smile broadly, also GERNE) [n -S]
GRISLED	grey (between black and white, also GRAY) [adj]
GRISONS	GRISON, a carnivorous animal [n]
GRISTER	one that grinds grain [n -S]
GRITTED	GRIT, to press the teeth together [v]
GRITTER	one that grits (to press the teeth together) [n -S]
GROANED	GROAN, to utter a low mournful sound, also GRONE [v]
GROANER	one that groans (to utter a low mournful sound, also GRONE) [n -S]
GRODIER	GRODY, sleazy (shoddy, also SLEAZO) [adj]
GROINED	GROIN, to build with intersecting arches [v]
GROSERS	GROSER, a gooseberry, also GROSERT, GROSET [n]
GROSERT	a gooseberry, also GROSER, GROSET [n -S]
GROSETS	GROSET, a gooseberry, also GROSER, GROSERT [n]
GROSSED	GROSS, to earn exclusive of deductions [v]
GROSSER	a product that yields much business [n -S]
GROTTOS	GROTTO, a cave [n]
GROUNDS	GROUND, to place on a foundation [v]
GROUSED	GROUSE, to complain (to express discontent) [v]
GROUSER	one that grouses (to complain (to express discontent)) [n -S]
GROUSES	GROUSE, to complain (to express discontent) [v]
GROUTED	GROUT, to fill a crack with thin mortar [v]
GROUTER	one that grouts (to fill a crack with thin mortar) [n -S]
GRUELED	GRUEL, to disable by hard work [v]
GRUELER	one that gruels, also GRUELLER [n -S]
GRUNDLE	(US slang) the perineum [n -S]
GRUNION	a small food fish [n -S]
GRUNTED	GRUNT, to utter a deep guttural sound [v]
GRUNTER	one that grunts (to utter a deep guttural sound) [n -S]
GRUNTLE	to put in good humour [v GRUNTLED, GRUNTLING, GRUNTLES]
GRUTTEN	GREET, to address courteously on meeting [v]
GUANASE	an enzyme (a complex protein, also ENZYM) [n -S]
GUANINE	a chemical compound, also GUANIN [n -S]
GUANINS	GUANIN, a chemical compound, also GUANINE [n]
GUARANA	a caffeine-rich drink made from a Brazilian plant [n -S]
GUARANI	a monetary unit of Paraguay [n GUARANIS or GUARANIES]
GUARDEE	a guardsman [n -S]
GUARDER	one that guards (to protect (to shield from harm, attack or injury)) [n -S]
GUELDER	as in guelder rose, a shrub of the genus Viburnum with large white balls of flowers [adj]
GUENONS	GUENON, a long-tailed monkey [n]
GUERDON	to reward (to give in return for some service or act) [v -ED, -ING, -S]
GUERITE	a turret (a small tower) [n -S]
GUESSED	GUESS, to form an opinion from little or no evidence [v]
GUESSER	one that guesses (to form an opinion from little or no evidence) [n -S]
GUESTED	GUEST, to appear as a visitor [v]
GUESTEN	to stay as a guest [v -ED, -ING, -S]
GUIDERS	GUIDER, one that guides (to show the way) [n]
GUIDONS	GUIDON, a small flag [n]
GUILDER	a monetary unit of the Netherlands, also GULDEN [n -S]
GUILERS	GUILER, a deceiver, also GUYLER [n]
GUISARD	a masker (one who wears a mask, also MASQUER) [n -S]
GUISERS	GUISER, a person in disguise, also GUIZER [n]
GUITARS	GUITAR, a stringed musical instrument [n]
GULDENS	GULDEN, a monetary unit of the Netherlands, also GUILDER [n]
GUNDIES	GUNDY, a toffee (a chewy candy, also TOFFY) [n]
GUNITES	GUNITE, a fine grained mixture of cement, sand and water [n]
GUNLESS	having no gun [adj]
GUNNELS	GUNNEL, a marine fish [n]
GUNNERA	a plant [n -S]
GUNNERS	GUNNER, one that operates a gun [n]
GUNNIES	GUNNY, a coarse fabric [n]
GUNSELS	GUNSEL, a gunman (one who is armed with a gun) [n]
GURLETS	GURLET, a pickaxe [n]
GURLIER	GURLY, grim (stern and unrelenting) [adj]
GURNARD	a marine fish, also GURNET [n -S]
GURRIES	GURRY, fish offal [n]
GUSLARS	GUSLAR, one who plays the gusla [n]
GUSSIED	GUSSIE, to dress up in fine or showy clothes, also GUSSY [v]
GUSTIER	GUSTY, blowing in gusts [adj]
GUSTOES	GUSTO, vigorous enjoyment [n]
GUTLESS	lacking courage [adj] : GUTLESSLY ~adv
GUTROTS	GUTROT, cheap alcohol [n]
GUTSERS	GUTSER, a heavy fall, also GUTZER [n]
GUTSIER	GUTSY, brave (showing courage) [adj]
GUTTERS	GUTTER, to form channels for draining off water [v]
GUTTIER	GUTTY, marked by courage [adj]
GUTTIES	GUTTY, latex, also GUTTA [n]
GUTTLED	GUTTLE, to eat rapidly [v]
GUTTLER	one that guttles (to eat rapidly) [n -S]
GUTTLES	GUTTLE, to eat rapidly [v]
IDLESSE	idleness (the state of being idle (inactive (indolent))) [n -S]
IDOLIST	someone who worships idols [n -S]
IGNATIA	a medicinal seed [n -S]
IGNITED	IGNITE, to set on fire [v]
IGNITOR	one that ignites, also IGNITER [n -S]
IGNORED	IGNORE, to intentionally disregard [v]
IGNORER	one who ignores (to intentionally disregard) [n -S]
IGUANAS	IGUANA, a large lizard, also IGUANID [n]
IGUANID	a large lizard, also IGUANA [n -S]
ILEITIS	inflammation of the ileum [n ILEITISES or ILEITIDES]
ILEUSES	ILEUS, an intestinal obstruction [n]
INANGAS	INANGA, the New Zealand whitebait [n]
INDENES	INDENE, a hydrocarbon [n]
INDIGEN	a native, also INDIGENE [n -S]
INDIGOS	INDIGO, a blue dye [n]
INDOORS	situated inside [adv]
INDUING	INDUE, to provide with, also ENDUE, INDEW [v]
INDULGE	to yield to the desire of [v INDULGED, INDULGING, INDULGES]
INDULIN	a blue dye, also INDULINE [n -S]
INDULTS	INDULT, a privilege granted by the pope [n]
INDUNAS	INDUNA, a South African tribal councillor [n]
INDUSIA	INDUSIUM, an enclosing membrane [n]
INGENER	an engineer [n -S]
INGENUE	a naive young woman [n -S]
INGENUS	INGENU, a naive young man [n]
INGESTS	INGEST, to take into the body [v]
INGINES	INGINE, ability (a special skill) [n]
INGOTED	INGOT, to shape into a convenient form for storage [v]
INGRAIN	to impress firmly on the mind [v -ED, -ING, -S]
INGROSS	to completely absorb one's attention, also ENGROSS [v -ED, -ING, -ES]
INISLED	INISLE, to put onto an island, also ENISLE [v]
INISLES	INISLE, to put onto an island, also ENISLE [v]
INITIAL	to mark with the first letters of one's name [v INITIALED or INITIALLED, INITIALLING, INITIALS]
INLANDS	INLAND, the interior of a country [n]
INNARDS	the internal organs [n]
INNLESS	without an inn [adj]
INOSINE	a compound of hypoxanthine and ribose [n -S]
INSANIE	insanity (the state of being insane (mentally unsound)) [n -S]
INSIDES	INSIDE, the part within [n]
INSIGNE	a sign of membership or honour [n INSIGNIA]
INSOULS	INSOUL, to infuse with a soul, also ENSOUL [v]
INSTALS	INSTAL, to place in position for use, also INSTALL [v]
INSTANT	a very short time [n -S]
INSTILS	INSTIL, to infuse slowly, also INSTILL [v]
INSULAR	an islander (one who lives on an island) [n -S]
INSULIN	a hormone (a secretion of the endocrine organs) [n -S]
INSULSE	dull (mentally slow) [adj]
INSULTS	INSULT, to subject to indignity [v]
INSURER	one that insures (to secure payment in the event of loss of damage) [n -S]
INSURES	INSURE, to secure payment in the event of loss of damage [v]
INTAGLI	INTAGLIO, an incised or sunken design [n]
INTENTS	INTENT, a purpose [n]
INTITLE	to give a right to, also ENTITLE, INTITULE [v INTITLED, INTITLING, INTITLES]
INTONED	INTONE, to speak in a singing voice [v]
INTRADA	a musical prelude [n -S]
INTRANT	someone that enters, also ENTRANT [n -S]
INTROIT	psalm or antiphon sung or said at the start of a service [n -S]
INTROLD	ENROLL, to insert on a register (pa p ENTROLD), also ENROL [v]
INTRUST	to give over for safe keeping, also ENTRUST [v -ED, -ING, -S]
INTUITS	INTUIT, to know without conscious reasoning [v]
INTURNS	INTURN, a turning inward [n]
INTUSES	INTUSE, a bruise [n]
INULINS	INULIN, a chemical compound [n]
INURING	INURE, to accustom oneself to accept unpleasant things [v]
INURNED	INURN, to put in an urn [v]
INUTILE	useless (serving no purpose) [adj]
IODINES	IODINE, a nonmetallic element, also IODIN [n]
IODISES	IODISE, to treat with iodine, also IODIZE [v]
IODURET	an iodide (a salt) [n -S]
IONISED	IONISE, to convert into ions, also IONIZE [v]
IONISES	IONISE, to convert into ions, also IONIZE [v]
IONOGEN	a compound capable of forming ions [n -S]
IONONES	IONONE, a chemical compound [n]
IRELESS	without anger [adj]
IRIDIAL	pertaining to the iris of the eye, also IRIDAL, IRIDIAN [adj]
IRIDIAN	pertaining to the iris of the eye, also IRIDAL, IRIDIAL [adj]
IRIDISE	to make iridescent, also IRIDIZE [v IRIDISED, IRIDISING, IRIDISES]
IRISING	IRIS, to give the form of a rainbow to [v]
IRONIER	IRONY, like iron [adj]
IRONING	clothes to be pressed [n -S]
ISATINS	ISATIN, a chemical compound, also ISATINE [n]
ISLANDS	ISLAND, to make into an area surrounded by water [v]
ISODONT	an animal with uniform teeth [n -S]
ISODOSE	one of several zones with equal radiation [n -S]
ISOETES	a type of plant [n ISOETES]
ISOGONS	ISOGON, a polygon having equal angles [n]
ISOLOGS	ISOLOG, a type of chemical compound, also ISOLOGUE [n]
ISSUANT	coming forth [adj]
ISSUING	ISSUE, to put into circulation [v]
ISTANAS	ISTANA, (Malaysia) a royal palace [n]
LAAGERS	LAAGER, to form a defensive encampment, also LAGER [v]
LADETTE	a lively woman who behaves like one of the lads [n -S]
LADINGS	LADING, cargo or freight [n]
LADINOS	LADINO, a fast-growing clover [n]
LADRONE	a thief, also LADRON [n -S]
LADRONS	LADRON, a thief, also LADRONE [n]
LAETARE	the fourth Sunday in Lent [n -S]
LAGENAS	LAGENA, a narrow-necked bottle [n]
LAGENDS	LAGEND, goods thrown into the sea for future recovery, also LAGAN, LIGAN [n]
LAGERED	LAGER, to form a defensive encampment, also LAAGER [v]
LAGOONS	LAGOON, a shallow body of water, also LAGUNA, LAGUNE [n]
LAGUNAS	LAGUNA, a shallow body of water, also LAGOON, LAGUNE [n]
LAGUNES	LAGUNE, a shallow body of water, also LAGOON, LAGUNA [n]
LAIDING	LAID, to burden (to load heavily) [v]
LAIRAGE	cattle housing [n -S]
LAIRIER	LAIRY, flashy (gaudy (tastelessly showy)) [adj]
LAIRING	LAIR, to live in a dwelling place for animals [v]
LANATED	covered with wool, also LANATE, LANOSE [adj]
LANDAUS	LANDAU, a type of carriage (a wheeled horse-drawn vehicle) [n]
LANDING	a place to disembark or board [n -S]
LANGARS	LANGAR, a dining hall in a Sikh place of worship [n]
LANGUED	having a tongue (heraldry) [adj]
LANGUES	LANGUE, a type of language [n]
LANGUET	a tongue-like part [n -S]
LANGUID	lacking vitality [adj]
LANGUOR	the state of being languid (lacking vitality) [n -S]
LANGURS	LANGUR, an Asian monkey [n]
LANIARD	a fastening rope on a ship, also LANYARD [n -S]
LANTANA	a tropical shrub [n -S]
LANTERN	to provide with a case for carrying a light [v -ED, -ING, -S]
LANUGOS	LANUGO, fine, soft hair [n]
LAOGAIS	LAOGAI, the system of forced labor camps in China [n]
LARDERS	LARDER, a place where food is stored [n]
LARDING	LARD, to smear with the melted fat of pigs [v]
LARDONS	LARDON, a strip of bacon, also LARDOON [n]
LARDOON	a strip of bacon, also LARDON [n -S]
LARGESS	generosity, also LARGESSE [n -ES]
LARIATS	LARIAT, to catch with a long rope with a running noose, also LASSO, LAZO [v]
LARNING	LARN, to teach (to instruct (to teach)) [v]
LASAGNA	an Italian baked pasta dish, also LASAGNE [n -S]
LASAGNE	an Italian baked pasta dish, also LASAGNA [n -S]
LASINGS	LASING, the act of using a laser [n]
LASSOED	LASSO, to catch with a long rope with a running noose, also LARIAT, LAZO [v]
LASTAGE	the lading of a ship [n -S]
LASTING	a durable fabric [n -S]
LATENED	LATEN, to become late (coming after the expected time) [v]
LATERAD	toward the side [adv]
LATESTS	LATEST, the most recent development [n]
LATINAS	LATINA, a female Latin American [n]
LATRANT	barking [adj]
LATRIAS	LATRIA, worship given to God alone in Catholicism [n]
LATTINS	LATTIN, a brass-like alloy, also LATTEN [n]
LAUDERS	LAUDER, one who lauds, also LAUDATOR [n]
LAUDING	LAUD, to praise (to express admiration or approval of) [v]
LAUNDER	to wash clothes [v -ED, -ING, -S]
LEADENS	LEADEN, to become heavy (weighty (having a great weight)) [v]
LEADING	a covering of lead [n -S]
LEAGUED	LEAGUE, to come together for a common purpose [v]
LEAGUER	to besiege (to attack and surround, also SIEGE) [v -ED, -ING, -S]
LEAGUES	LEAGUE, to come together for a common purpose [v]
LEANING	a tendency (a trend or inclination, also TENDENZ) [n -S]
LEARIER	LEARY, suspicious [adj]
LEARNED	LEARN, to be informed [v]
LEARNER	one who learns (to be informed) [n -S]
LEDGERS	LEDGER, to fish with a ledger-line [v]
LEDGIER	LEDGY, abounding in ledges (a narrow, shelflike projection) [adj]
LEERIER	LEERY, suspicious [adj]
LEERING	the act of leering [n -S]
LEESING	LEESE, to lose (to misplace or be deprived of) [v]
LEGATED	LEGATE, to bequeath (to leave by will) [v]
LEGATEE	the inheritor of a legacy, also LEGATARY [n -S]
LEGATES	LEGATE, to bequeath (to leave by will) [v]
LEGATOR	one that legates (to bequeath (to leave by will)) [n -S]
LEGENDS	LEGEND, an unverified story from earlier times [n]
LEGISTS	LEGIST, one skilled in the law [n]
LEGSIDE	that half of a cricket field on the side on which the batsman stands when waiting to receive the ball [n -S]
LEGUAAN	(South Africa) a very large lizard [n -S]
LEGUANS	LEGUAN, a large monitor lizard of the genus Varanus, also LEGUAAN [n]
LEIDGER	the financial record-book of a company, also LEIGER [n -S]
LEIGERS	LEIGER, the financial record-book of a company, also LEIDGER [n]
LEIRING	LEIR, to teach (to instruct (to teach)) [v]
LEISURE	to have recreational time [v LEISURED, LEISURING, LEISURES]
LENDERS	LENDER, one who lends (to give for a time only) [n]
LENDING	the act of giving in loan [n -S]
LENGEST	longest (far-extending) [adj]
LENIENT	a softening application like a poultice [n -S]
LENITED	LENITE, to articulate a lenis [v]
LENSING	LENS, to make a film of [v]
LENTOUS	relating to lentor [adj]
LEONINE	pertaining to a lion (a large, carnivorous, feline animal) [adj]
LEOTARD	a close-fitting garment [n -S]
LETTERN	a reading desk [n -S]
LETTERS	LETTER, to inscribe with symbols of speech sounds [v]
LETTING	the act of letting [n -S]
LETTRES	LETTRE, a letter [n]
LIAISES	LIAISE, to form a link with [v]
LIAISON	a means of maintaining communication [n -S]
LIANOID	pertaining o a liana [adj]
LIATRIS	a North American plant with small white flowers [n -ES]
LIDGERS	LIDGER, the financial record book of a company, also LIEGER [n]
LIEGERS	LIEGER, the financial record book of a company, also LIDGER [n]
LIGANDS	LIGAND, a type of ion or molecule [n]
LIGASES	LIGASE, an enzyme (a complex protein, also ENZYM) [n]
LIGATED	LIGATE, to bind, also LIGATURE [v]
LIGNANS	LIGNAN, a type of polymer (a complex chemical compound) [n]
LIGNINS	LIGNIN, an essential part of woody tissue [n]
LIGNITE	a type of coal [n -S]
LIGROIN	a flammable liquid, also LIGROINE [n -S]
LIGURES	LIGURE, a precious stone [n]
LINDANE	an insecticide [n -S]
LINDENS	LINDEN, a tall forest tree [n]
LINDIES	LINDY, a lively dance [n]
LINEAGE	direct descent from an ancestor [n -S]
LINGIER	LINGY, covered with heaths [adj]
LINGOTS	LINGOT, an ingot [n]
LINGUAE	LINGUA, the tongue [n]
LINGUAS	LINGUA, the tongue [n]
LININGS	LINING, an inner layer [n]
LINNIES	LINNY, a shed, also LINHAY, LINNEY [n]
LINSANG	a carnivorous mammal [n -S]
LINSEED	flaxseed (the seed of flax) [n -S]
LINTING	LINT, to put lint on [v]
LINURON	a herbicide [n -S]
LISTING	something that is listed [n -S]
LOADING	a burden [n -S]
LOANING	a lane (a narrow passageway, also LANEWAY) [n -S]
LODGERS	LODGER, one who stays in rented accommodation [n]
LOGANIA	one of the family of Australian plans [n -S]
LOGIONS	LOGION, a saying attributed to Jesus [n]
LOGOUTS	LOGOUT, to exit from a computer mainframe or server, also LOGOFF [v]
LOIDING	LOID, to open with a strip of celluloid [v]
LONGANS	LONGAN, the edible fruit of a Chinese tree, also LUNGAN [n]
LONGERS	LONGER, one that longs (to yearn for) [n]
LONGEST	LONG, far-extending [adj]
LOONING	a cry of a bird [n -S]
LOOSENS	LOOSEN, to make less tight [v]
LOOSEST	LOOSE, slack (not tight or taut, also SLACKEN) [adj]
LOOSIES	cigarettes sold individually [n]
LOOSING	an act of loosing [n -S]
LOOTING	the act of looting [n -S]
LORDING	a young or unimportant lord, also LORDLING [n -S]
LORETTE	a courtesan [n -S]
LORGNON	a pair of eyeglasses with a handle [n -S]
LORINGS	LORING, teaching (a doctrine (a belief taught or advocated)) [n]
LORIOTS	LORIOT, the golden oriole [n]
LOSINGS	LOSING, a loss (the act of one the loses) [n]
LOTIONS	LOTION, a liquid preparation for external application [n]
LOTOSES	LOTOS, an aquatic plant, also LOTUS [n]
LOTTING	LOT, to allot or distribute [v]
LOTUSES	LOTUS, an aquatic plant, also LOTOS [n]
LOUDENS	LOUDEN, to increase in volume [v]
LOUDEST	LOUD, strongly audible [adj]
LOUNDER	to beat (to strike repeatedly) [v -ED, -ING, -S]
LOUNGED	LOUNGE, to recline in a relaxed manner [v]
LOUNGER	one who lounges (to recline in a relaxed manner) [n -S]
LOUNGES	LOUNGE, to recline in a relaxed manner [v]
LOUNING	LOUN, to calm, also LOUND [v]
LOURIER	LOURY, sullen (showing brooding ill humour) [adj]
LOURING	the act of scowling (to frown angrily) [n -S]
LOUSERS	LOUSER, an unpleasant person [n]
LOUSING	LOUSE, to spoil or bungle [v]
LOUTING	LOUT, to bow (to curtsey (to bow politely, also CURTSY)) [v]
LUNATED	crescent-shaped, also LUNATE [adj]
LUNETTE	a crescent-shaped object, also LUNET [n -S]
LUNGANS	LUNGAN, the edible fruit of a Chinese tree, also LONGAN [n]
LUNGEES	LUNGEE, a loincloth worn by men in India, also LUNGI, LUNGYI [n]
LUNGERS	LUNGER, one that lunges (to make a sudden plunge forward) [n]
LUNGIES	LUNGIE, a diving bird [n]
LUNTING	LUNT, to emit smoke [v]
LURDANE	a lazy or stupid person, also LURDAN, LURDEN [n -S]
LURDANS	LURDAN, a lazy or stupid person, also LURDANE, LURDEN [n]
LURDENS	LURDEN, a lazy or stupid person, also LURDAN, LURDANE [n]
LURGIES	LURGY, a fictitious disease, also LURGI [n]
LURIDER	LURID, ghastly (terrifying) [adj]
LURINGS	LURING, as in tape luring, the enticement and subsequent capture of a seabird by playing tape recordings of its call from beaches and cliffs [n]
LURRIES	LURRY, any garbled formula [n]
LUSTERS	LUSTER, to make lustrous, also LUSTRE [v]
LUSTING	LUST, to have a strong sexual desire for [v]
LUSTRED	LUSTRE, to make lustrous, also LUSTER [v]
LUSTRES	LUSTRE, to make lustrous, also LUSTER [v]
LUTINGS	LUTING, a substance used as a sealant [n]
LUTISTS	LUTIST, one who plays the lute, also LUTANIST, LUTENIST [n]
LUTITES	LUTITE, any rock derived from clay or mud. Also PELITE [n]
NADIRAL	pertaining to nadir (the lowest point of the heavens) [adj]
NAGANAS	NAGANA, a horse disease, also NGANA [n]
NAGARIS	NAGARI, a type of Indian script [n]
NAILING	making nails [n -S]
NANDOOS	NANDOO, a South American ostrich, also NANDU, NHANDU [n]
NANODOT	a small cluster of metal atoms which can store much data [n -S]
NARASES	NARAS, a melonlike fruit, also NARRAS [n]
NARDING	NARD, to anoint with the aromatic oil spikenard [v]
NARDOOS	NARDOO, an Australian fern [n]
NARRATE	to tell a story [v NARRATED, NARRATING, NARRATES]
NASARDS	NASARD, an organ stop [n]
NASIONS	NASION, a point in the skull [n]
NASUTES	NASUTE, a type of white ant [n]
NATURAE	NATURA, nature (the power that creates and regulates the world) [n]
NATURAL	a type of musical note [n -S]
NATURED	having a certain disposition [adj]
NAUSEAS	NAUSEA, an inclination to vomit [n]
NAUTILI	NAUTILUS, a spiral-shelled mollusk [n]
NEALING	NEAL, to anneal (to toughen (to make tough (strong and resilient))) [v]
NEDETTE	a female ned (a young hooligan) [n -S]
NEEDERS	NEEDER, one that needs (to require (to have need of)) [n]
NEEDIER	NEEDY, in a state of poverty [adj]
NEEDING	NEED, to require (to have need of) [v]
NEEDLER	one that needles (to sew with a slender, pointed instrument) [n -S]
NEEDLES	NEEDLE, to sew with a slender, pointed instrument [v]
NEESING	NEESE, to sneeze, also NEEZE [v]
NEGATED	NEGATE, to nullify (to negate) [v]
NEGATON	an electron, also NEGATRON [n -S]
NEGRESS	a Negro woman [n -ES]
NEGROES	NEGRO, a dark-skinned African [n]
NEGROID	a member of the black race [n -S]
NEGRONI	an alcoholic beverage, also NEGUS [n -S]
NEGUSES	NEGUS, an alcoholic beverage, also NEGRONI [n]
NEINEIS	NEINEI, a New Zealand shrub [n]
NELSONS	NELSON, a wrestling hold [n]
NEOGENE	relating to the Miocene or Pliocene epochs [adj]
NEONATE	a newborn child [n -S]
NEOSOUL	a style of popular music combining traditional soul music with elements from other genres [n -S]
NERDIER	NERDY, socially inept, also NURDY, NURDISH, NERDISH [adj]
NESTING	the act of making nests [n -S]
NESTLED	NESTLE, to lie snugly together [v]
NESTLES	NESTLE, to lie snugly together [v]
NETLESS	without a net [adj]
NETROOT	a political activist who promotes his or her cause via the internet [n -S]
NETTING	a net [n -S]
NETTLED	NETTLE, to make angry (feeling hostility) [v]
NETTLER	one that nettles (to make angry (feeling hostility)) [n -S]
NETTLES	NETTLE, to make angry (feeling hostility) [v]
NEURINE	a ptomaine poison [n -S]
NEUROID	resembling a nerve [adj]
NEURONE	the basic cellular unit of the nervous system, also NEURON [n -S]
NEURONS	NEURON, the basic cellular unit of the nervous system, also NEURONE [n]
NEUSTON	an aggregate of small aquatic organisms [n -S]
NEUTRAL	one that is impartial [n -S]
NEUTRON	a subatomic particle, also NEUTRINO [n -S]
NGARARA	a lizard found in New Zealand [n -S]
NIDINGS	NIDING, an infamous person, also NITHING, NIDERING [n]
NIDUSES	NIDUS, a breeding place [n]
NIGIRIS	NIGIRI, a small oval block of cold rice, wasabi and fish [n]
NILGAIS	NILGAI, a large antelope, also NILGAU, NILGHAI, NILGHAU, NYLGHAI, NYLGHAU [n]
NILGAUS	NILGAU, a large antelope, also NILGAI, NILGHAI, NILGHAU, NYLGHAI, NYLGHAU [n]
NIRLIER	NIRLY, knotty (full of knots) [adj]
NIRLING	NIRL, to stunt (to hinder from growth) [v]
NISGULS	NISGUL, (English dialect) the smallest and weakest in a brood of chickens [n]
NITINOL	an alloy of nickel and titanium [n -S]
NITRIDS	NITRID, a compound of nitrogen [n]
NITRILS	NITRIL, a chemical compound, also NITRILE [n]
NODULAR	relation to a nodule [adj]
NODULES	NODULE, a small node (a swollen enlargement) [n]
NOINTED	NOINT, to anoint (to consecrate with oil) [v]
NOISING	NOISE, to spread as a rumour or report [v]
NONAGED	pertaining to nonage (a period of immaturity) [adj]
NONAGES	NONAGE, a period of immaturity [n]
NONDRUG	not involving drugs [adj]
NONEGOS	NONEGO, all that is not part of the ego [n]
NONETTE	a musical piece for nine players, also NONET, NONETTO [n -S]
NONETTI	NONETTO, a musical piece for nine players, also NONET, NONETTE [n]
NONETTO	a musical piece for nine players, also NONET, NONETTE [n NONETTOS or NONETTI]
NONORAL	not oral [adj]
NONSUIT	to dismiss the lawsuit of [v -ED, -ING, -S]
NONUSER	one that is not a user [n -S]
NONUSES	NONUSE, failure to use [n]
NOODGES	NOODGE, to nag, also NUDZH [v]
NOODLES	NOODLE, to play idly on a musical instrument [v]
NOONERS	NOONER, an activity held during the lunch-break [n]
NOOSERS	NOOSER, one that nooses (to secure with a type of loop) [n]
NOOSING	NOOSE, to secure with a type of loop [v]
NORLAND	a region in the north [n -S]
NORSELS	NORSEL, to attach fastening lines to a net [v]
NORTENA	a female norteno (a North American in contrast to a Latin American) [n -S]
NORTENO	a North American in contrast to a Latin American [n -S]
NOSEANS	NOSEAN, a cubic mineral, also NOSELITE [n]
NOSINGS	NOSING, a projecting edge [n]
NOSODES	NOSODE, a type of homeopathic remedy [n]
NOTANDA	NOTANDUM, something to be specially noted [n]
NOTATED	NOTATE, to put into a system of symbols [v]
NOTELET	a short letter [n -S]
NOTIONS	NOTION, a general idea [n]
NOTITIA	a list [n NOTITIAS or NOTITIAE]
NOUGATS	NOUGAT, a chewy candy [n]
NOUNIER	NOUNY, having many nouns [adj]
NOURSLE	to foster, also NOUSELL, NOUSLE, NURSLE [v NOURSLED, NOURSLING, NOURSLES]
NOUSLED	NOUSLE, to foster, also NOURSLE, NOUSELL, NURSLE [v]
NOUSLES	NOUSLE, to foster, also NOURSLE, NOUSELL, NURSLE [v]
NUDGERS	NUDGER, one that nudges (to poke gently) [n]
NUDISTS	NUDIST, an advocate of nudism (the practice of going nude) [n]
NURDIER	NURDY, socially inept, also NERDY, NURDISH, NERDISH [adj]
NURDLES	NURDLE, to glide the ball in cricket [v]
NURLING	NURL, to make grooves in [v]
NURSERS	NURSER, a baby's bottle [n]
NURSING	the profession of one who nurses [n -S]
NURSLED	NURSLE, to foster, also NOURSLE, NOUSELL, NOUSLE [v]
NURSLES	NURSLE, to foster, also NOURSLE, NOUSELL, NOUSLE [v]
NUTATED	NUTATE, to droop (to hang downward) [v]
NUTATES	NUTATE, to droop (to hang downward) [v]
NUTLETS	NUTLET, a small nut [n]
NUTTING	the act of gathering nuts [n -S]
OARAGES	OARAGE, a rowing movement [n]
ODONATE	any of the order of predacious insects [n -S]
ODORANT	an odorous substance [n -S]
ODORATE	emitting a smell [adj]
OESTRUS	the period of heat in female mammals, also ESTRUM, OESTRUM, ESTRUS [n -ES]
OILNUTS	OILNUT, a North American butter nut [n]
OINTING	OINT, to anoint (to consecrate with oil) [v]
OLDNESS	the state of being old (living for a long time) [n -ES]
OLEARIA	an Australian daisy-tree [n -S]
OLIGIST	crystallized haematite [n -S]
OLINGOS	OLINGO, a small mammal of Central and South America [n]
OLOGIES	OLOGY, a branch of knowledge [n]
OLOGIST	an expert in a particular ology [n -S]
ONDATRA	a large American vole [n -S]
ONDINES	ONDINE, a female water spirit, also UNDINE [n]
ONDINGS	ONDING, an onset (a beginning) [n]
ONENESS	unity (the state of being one single entity) [n -ES]
ONERIER	ONERY, stubborn and mean-spirited [adj]
ONEROUS	burdensome [adj]
ONIONED	ONION, to apply an edible bulb to [v]
ONLOADS	ONLOAD, to load a vehicle or container [v]
ONSIDES	ONSIDE, a cricket term [n]
OODLINS	a large amount, also OODLES [n OODLES]
OORALIS	OORALI, a curare (an arrow poison, also CURARI, URARE, URARI) [n]
OORIALS	OORIAL, a Himalayan sheep, also URIAL [n]
OOSIEST	OOSY, having fluff [adj]
ORANGER	ORANGE, the colour of an orange (a fruit) [adj]
ORARIAN	a coast-dweller [n -S]
ORARION	a type of stole (a long, wide scarf) [n ORARIONS or ORARIA]
ORATING	ORATE, to speak formally [v]
ORATION	a formal speech [n -S]
ORATORS	ORATOR, one that orates (to speak formally) [n]
ORDINAL	a number indicating order of sequence [n -S]
ORDINAR	something quite usual, also ORDINARY [n -S]
ORDINEE	one that is being ordained [n -S]
ORDURES	ORDURE, manure [n]
OREGANO	an aromatic herb [n -S]
ORGANON	a system of rules for scientific investigation, also ORGANUM [n ORGANONS or ORGANA]
ORGIAST	one who takes place in orgies [n -S]
ORGONES	ORGONE, a vital force permeating the universe [n]
ORIGINS	ORIGIN, first existence [n]
ORISONS	ORISON, a prayer (a devout petition to a deity) [n]
ORNATER	ORNATE, decorated [adj]
OROGENS	OROGEN, a region which has undergone orogeny [n]
OROTUND	full and clear in sound [adj]
ORRISES	ORRIS, a flowering plant, also ORRICE [n]
ORTOLAN	a European bird [n -S]
OSSELET	a substance growing on the inside of a horse's knee [n -S]
OSTENTS	OSTENT, appearance [n]
OTALGIA	pain in the ear, also OTALGY [n -S]
OTTERED	OTTER, to fish with a board of baited lines [v]
OUGLIED	OUGLIE, to make ugly (pr p OUGLIEING), also OUGHLY [v]
OUGLIES	OUGLIE, to make ugly (pr p OUGLIEING), also OUGHLY [v]
OULDEST	OULD, old (living for a long time) [adj]
OULONGS	OULONG, a variety of black tea, also OOLONG [n]
OURALIS	OURALI, a plant which yields curare, also URALI, WOURALI [n]
OURANGS	OURANG, a large ape, also ORANG [n]
OURARIS	OURARI, an arrow poison [n]
OUSTERS	OUSTER, the act or ousting [n]
OUSTING	OUST, to expel (to force out) [v]
OUSTITI	a lock-opening tool [n -S]
OUTAGES	OUTAGE, a failure in use [n]
OUTDARE	to surpass in daring [v OUTDARED, OUTDARING, OUTDARES]
OUTDATE	to make out-of-date [v OUTDATED, OUTDATING, OUTDATES]
OUTDOER	one that outdoes (to exceed in performance) [n -S]
OUTDOES	OUTDO, to exceed in performance [v]
OUTDONE	OUTDO, to exceed in performance [v]
OUTDRAG	to surpass in drag racing [v OUTDRAGGED, OUTDRAGGING, OUTDRAGS]
OUTEARN	to surpass in earning [v -ED, -ING, -S]
OUTEATS	OUTEAT, to surpass in eating [v]
OUTEDGE	the farthermost bound [n -S]
OUTGAIN	to gain more than [v -ED, -ING, -S]
OUTGATE	an exit [n -S]
OUTGOER	someone who is outgoing [n -S]
OUTGOES	OUTGO, to go beyond [v]
OUTGONE	OUTGO, to go beyond [v]
OUTGRIN	to surpass in grinning [v OUTGRINNED, OUTGRINNING, OUTGRINS]
OUTINGS	OUTING, a short pleasure trip [n]
OUTLAID	OUTLAY, to pay out [v]
OUTLAIN	OUTLIE, to lie beyond [v]
OUTLAND	a foreign land [n -S]
OUTLAST	to last longer than [v -ED, -ING, -S]
OUTLEAD	to surpass in leading [v OUTLED, OUTLEADING, OUTLEADS]
OUTLETS	OUTLET, a vent or passage [n]
OUTLIED	OUTLIE, to lie beyond [v]
OUTLIER	some part detached from the main portion [n -S]
OUTNESS	the state of being out [n -ES]
OUTRAGE	to arouse anger or resentment in [v OUTRAGED, OUTRAGING, OUTRAGES]
OUTRANG	OUTRING, to ring louder than [v]
OUTRATE	to surpass in rating [v OUTRATED, OUTRATING, OUTRATES]
OUTREAD	to surpass in reading [v -ING, -S]
OUTRIDE	to ride faster than [v OUTRODE or OUTRIDDEN, OUTRIDDEN, OUTRIDING, OUTRIDES]
OUTRIGS	OUTRIG, to equip (a boat) with outriggers (projections having floats) [v]
OUTRING	to ring louder than [v OUTRANG or OUTRUNG, OUTRINGING, OUTRINGS]
OUTROAR	to roar louder than [v -ED, -ING, -S]
OUTRODE	OUTRIDE, to ride faster than [v]
OUTSAID	OUTSAY, to surpass in saying [v]
OUTSANG	OUTSING, to surpass in singing [v]
OUTSEEN	OUTSEE, to see beyond [v]
OUTSEES	OUTSEE, to see beyond [v]
OUTSERT	a sheet enclosing a folded article [n -S]
OUTSETS	OUTSET, a beginning [n]
OUTSING	to surpass in singing [v OUTSANG, OUTSUNG, OUTSINGING, OUTSINGS]
OUTSINS	OUTSIN, to surpass in sinning (to offend against moral or religious law) [v]
OUTSITS	OUTSIT, to sit longer than [v]
OUTSOAR	to soar beyond [v -ED, -ING, -S]
OUTSOLD	OUTSELL, to sell more than [v]
OUTSOLE	the outer sole of a boot or shoe [n -S]
OUTTOLD	OUTTELL, to say openly [v]
RADIALS	RADIAL, a part diverging from a centre [n]
RADIANS	RADIAN, a unit of angular measure [n]
RADIANT	a point from which rays are omitted [n -S]
RADIATA	a variety of pine tree, pinus radiata [n -S]
RADULAE	RADULA, a tonguelike organ of molluscs [n]
RADULAR	resembling a radula (a tonguelike organ of molluscs) [adj]
RADULAS	RADULA, a tonguelike organ of molluscs [n]
RAGINIS	RAGINI, a modified raga [n]
RAGLANS	RAGLAN, a type of overcoat (a warm coat worn over clothing) [n]
RAGOUTS	RAGOUT, to make into a highly seasoned stew [v]
RAGULED	with projections like stubs of branches, also RAGULY [adj]
RAIDING	the act of raiding [n -S]
RAILAGE	(The cost of) transportation by railway [n -S]
RAILING	a fence-like barrier [n -S]
RAINIER	RAINY, marked by rain [adj]
RAINING	RAIN, to fall in drops of water [v]
RAINOUT	atomic fallout occurring in precipitation [n -S]
RAISERS	RAISER, one that raises (to lift (to raise higher)) [n]
RAISING	an elevation [n -S]
RAISINS	RAISIN, a dried grape [n]
RAITING	RAIT, to expose to moisture [v]
RANDANS	RANDAN, a boat rowed by three persons [n]
RANDING	RAND, to rant (to declaim bombastically) [v]
RANDONS	RANDON, a rush [n]
RANGERS	RANGER, an officer supervising the care of a forest [n]
RANGOLI	Hindu decoration [n -S]
RANTING	the act of ranking [n -S]
RANULAR	relating to a ranula [adj]
RANULAS	RANULA, a cyst formed under the tongue [n]
RAOULIA	a large, white plant [n -S]
RASSLED	RASSLE, to wrestle (to grapple with, also WRASSLE, WRASTLE, WRAXLE) [v]
RASTERS	RASTER, the area reproducing images on the picture tube of a television set [n]
RASURES	RASURE, an erasure (the act of erasing (to efface or rub out)) [n]
RATLING	one of the ropes forming the steps of a ladder on a ship, also RATLINE, RATLIN, RATTLIN, RATTLINE [n -S]
RATTAIL	a marine fish [n -S]
RATTANS	RATTAN, a climbing plant with long thin stems, also ROTAN, RATAN [n]
RATTERS	RATTER, an animal used for catching rats [n]
RATTING	rat-hunting [n -S]
RATTLED	RATTLE, to make a quick succession of short, sharp sounds [v]
RATTLER	one that rattles (to make a quick succession of short, sharp sounds) [n -S]
RATTLIN	one of the ropes forming the steps of a ladder on, also RATLINE, RATLIN, RATLING, RATTLINE [n -S]
RATTOON	to sprout from a root planted the previous year, also RATOON [v -ED, -ING, -S]
RAUNGED	RAUNGE, to set in a row [v]
RAUNGES	RAUNGE, to set in a row [v]
READERS	READER, one who reads (to look at and understand written matter) [n]
READIER	READY, prepared [adj]
READORN	to adorn again [v -ED, -ING, -S]
READOUT	a presentation of computer data [n -S]
REALGAR	a mineral, also ROSAKER [n -S]
REALTER	to alter again [v -ED, -ING, -S]
REALTOR	a agent for buying or selling property [n -S]
REARGUE	to argue again [v REARGUED, REARGUING, REARGUES]
REDEALT	REDEAL, to deal again [v]
REDEARS	REDEAR, the common sunfish [n]
REDLEGS	REDLEG, a bird with red legs [n]
REDLINE	to withhold loans or insurance from certain neighborhoods [v REDLINED, REDLINING, REDLINES]
REDNESS	the state of being red (the colour of blood, also REDD) [n -ES]
REDOING	REDO, to do something again [v]
REDRESS	to set right [v -ED, -ING, -ES]
REDROOT	a perennial herb [n -S]
REDSEAR	brittle at red-heat, also REDSHARE, REDSHIRE, REDSHORT [adj]
REEDERS	REEDER, a thatcher (one who thatches (to cover with foliage)) [n]
REEDIER	REEDY, abounding in reeds [adj]
REEDING	a convex moulding [n -S]
REELERS	REELER, one that reels (to wind on a type of rotary device) [n]
REELING	the act of reeling [n -S]
REENTER	to enter again [v -ED, -ING, -S]
REESTED	REEST, to balk (to refrain from proceeding, also BAUK, BAULK) [v]
REGALED	REGALE, to delight (to give great pleasure to) [v]
REGALER	one who regales (to delight (to give great pleasure to)) [n -S]
REGALIA	a big cigar (a roll of tobacco leaves for smoking) [n -S]
REGARDS	REGARD, to esteem highly [v]
REGATTA	a boat race [n -S]
REGEARS	REGEAR, to equip again [v]
REGESTS	REGEST, a register [n]
REGILDS	REGILD, to gild once more [v]
REGLETS	REGLET, a flat, narrow moulding [n]
REGLOSS	to glass again [v -ED, -ING, -ES]
REGLUED	REGLUE, to glue again [v]
REGLUES	REGLUE, to glue again [v]
REGOSOL	a type of soil [n -S]
REGRADE	to grade again [v REGRADED, REGRADING, REGRADES]
REGRATE	to buy up in order to sell for a higher price in the same area [v REGRATED, REGRATING, REGRATES]
REGREDE	to retrograde [v REGREDED, REGREDING, REGREDES]
REGREEN	to green again [v -ED, -ING, -S]
REGREET	to greet in return [v -ED, -ING, -S]
REGRESS	to go back [v -ED, -ING, -ES]
REGRETS	REGRET, to look back upon with sorrow or remorse [v]
REGRIND	to grind again [v REGROUND, REGRINDING, REGRINDS]
REGULAE	REGULA, the rule of a religious order [n]
REGULAR	a habitual customer [n -S]
REGULOS	REGULO, the scale of temperature in a gas oven [n]
REIGNED	REIGN, to exercise sovereign power [v]
REINING	REIN, to restrain (to hold back) [v]
REISSUE	to issue again [v REISSUED, REISSUING, REISSUES]
RELATED	RELATE, to give an account of [v]
RELATER	one who relates, also RELATOR [n -S]
RELATOR	one who relates, also RELATER [n -S]
RELEARN	to learn again [v RELEARNED, RELEARNT, RELEARNING, RELEARNS]
RELENDS	RELEND, to lend again [v]
RELIERS	RELIER, one that relies (to depend on confidently) [n]
RELINED	RELINE, to line again [v]
RENAGUE	to be a turncoat [v RENAGUED, RENAGUING, RENAGUES]
RENDERS	RENDER, to plaster with a first coat [v]
RENDING	REND, to tear apart forcibly [v]
RENEGED	RENEGE, to fail to carry out a promise, also RENIG [v]
RENEGER	one who reneges (to fail to carry out a promise, also RENIG) [n -S]
RENEGES	RENEGE, to fail to carry out a promise, also RENIG [v]
RENEGUE	to renounce, also RENEY [v RENEGUED, RENEGUING, RENEGUES]
RENTING	the act of renting [n -S]
REOILED	REOIL, to oil again [v]
REREADS	REREAD, to read again [v]
REREDOS	an ornamental screen behind an altar [n REREDOSES or REREDOSSES]
RERISES	RERISE, to rise again [v]
REROUTE	to choose a different route [v REROUTED, REROUTEING, REROUTES]
RESEAUS	RESEAU, a filter screen for making colour films [n]
RESEDAS	RESEDA, a flowering plant [n]
RESEEDS	RESEED, to seed again [v]
RESENDS	RESEND, to send again [v]
RESILES	RESILE, to spring back [v]
RESOLED	RESOLE, to put on new soles [v]
RESOLES	RESOLE, to put on new soles [v]
RESORTS	RESORT, to sort again or differently [v]
RESTART	to start again [v -ED, -ING, -S]
RESTERS	RESTER, one that rests (to stop word or activity for repose) [n]
RESULTS	RESULT, to follow as a consequence [v]
RESURGE	to rise again [v RESURGED, RESURGING, RESURGES]
RETESTS	RETEST, to test again [v]
RETILED	RETILE, to tile again [v]
RETIRED	RETIRE, to withdraw or retreat [v]
RETIREE	one who has retired from his vocation, also RETIRANT [n -S]
RETITLE	to give a new title to [v RETITLED, RETITLING, RETITLES]
RETORTS	RETORT, to answer back [v]
RETOTAL	to total again [v RETOTALLED, RETOTALLING, RETOTALS]
RETOURS	RETOUR, to return as heir [v]
RETRATE	to draw back [v RETRATED, RETRATING, RETRATES]
RETREAD	to tread again [v RETROD or RETREADED, RETRODDEN, RETREADING, RETREADS] / to furnish with new tread (pa t RETROD) [n -S]
RETREAT	to go back [v -ED, -ING, -S]
RETREES	RETREE, slightly damaged paper [n]
RETRIED	RETRY, to try again [v]
RETTING	RET, to expose to moisture [v]
RETUNED	RETUNE, to tune again [v]
REUNION	a uniting of people after separation [n -S]
REURGED	REURGE, to press strongly [v]
REURGES	REURGE, to press strongly [v]
REUTTER	to utter again [v -ED, -ING, -S]
RIDGELS	RIDGEL, a male animal whose testicles have not descended, also RIDGLING, RIDGIL [n]
RIDGERS	RIDGER, a type of plough [n]
RIDGIER	RIDGY, having ridges [adj]
RIDGILS	RIDGIL, a male animal whose testicles have not descended, also RIDGLING, RIDGEL [n]
RIDINGS	RIDING, anchorage [n]
RIDOTTO	a public musical entertainment in 18th century England [n -S]
RIGIDER	RIGID, stiff (not easily bent) [adj]
RIGLINS	RIGLIN, a male animal with only one testicle, also RIGGALD, RIGLING [n]
RIGOURS	RIGOUR, failure to react to stimulus, also RIGOR [n]
RIGOUTS	RIGOUT, a person's distinctive costume [n]
RINDIER	RINDY, covered in rind [adj]
RINDING	RIND, to bark (to cry like a dog) [v]
RINGENT	having open liplike parts [adj]
RINGLET	a small ring [n -S]
RINSERS	RINSER, one that rinses (to cleanse with clear water) [n]
RINSING	the act of one that rinses (to cleanse with clear water) [n -S]
RIOTING	the act of rioting [n -S]
RIOTOUS	characterized by rioting [adj]
RISINGS	RISING, the act of one that rises (to move upward) [n]
RISORII	RISORIUS, a facial muscle situated at the corner of the mouth [n]
RISOTTO	a rice dish [n -S]
RISTRAS	RISTRA, a string on which foodstuffs are tied for storage [n]
RITARDS	RITARD, a musical passage with a slowing tempo [n]
RITTERS	RITTER, a knight [n]
RITTING	RIT, to scratch (to make a thin, shallow cut on) [v]
RITUALS	RITUAL, a system of rites [n]
ROADING	a wood-cock's evening flight, also RODING [n -S]
ROARING	a disease of horses marked by roaring [n -S]
ROATING	ROATE, to learn by repetition, also ROTE [v]
RODINGS	RODING, a wood-cock's evening flight, also ROADING [n]
RODLESS	without a rod [adj]
ROGERED	ROGER, to copulate with [v]
ROGNONS	ROGNON, an isolated rock outcrop on a glacier [n]
ROGUERS	ROGUER, a rogue [n]
ROILIER	ROILY, muddy (covered with mud) [adj]
ROILING	ROIL, to make muddy (covered with mud) [v]
ROINING	ROIN, to mutter (to murmur (to make a subdued muttered sound)) [v]
RONDEAU	a short poem of fixed form [n RONDEAUX]
RONDINO	a short rondo [n -S]
RONDURE	a circle or sphere [n -S]
RONEOED	RONEO, to copy with a duplicator [v]
RONIONS	RONION, a mangy animal or person, also RONYON [n]
RONNELS	RONNEL, an insecticide [n]
RONTGEN	a unit of radiation dosage, also ROENTGEN [n -S]
ROOSERS	ROOSER, one who rooses (to praise (to express admiration or approval of)) [n]
ROOSING	ROOSE, to praise (to express admiration or approval of) [v]
ROOSTER	a domestic cock [n -S]
ROOTAGE	a system of roots [n -S]
ROOTERS	ROOTER, a vocal supporter [n]
ROOTIER	ROOTY, full of roots [adj]
ROOTING	the act of rooting [n -S]
ROOTLED	ROOTLE, to grub (to dig (to excavate (to dig out))) [v]
ROOTLET	a small root [n -S]
RORTING	the falsification of accounts [n -S]
ROSALIA	ascending music [n -S]
ROSARIA	ROSARIUM, a rose garden [n]
ROSIERE	a rose bush [n -S]
ROSIERS	ROSIER, a rose bush [n]
ROSINOL	a rosin oil [n -S]
ROSTERS	ROSTER, to put on a list of duties [v]
ROSTRAL	pertaining to a rostrum (a beaklike process or part) [adj]
ROSULAS	ROSULA, a leaf-rosette [n]
ROTATED	ROTATE, to turn like a wheel [v]
ROTATOR	a muscle serving to rotate a part of the body [n ROTATORS or ROTATORES] / one that rotates (to turn like a wheel) [n ROTATORS or ROTATORES]
ROTGUTS	ROTGUT, an inferior liquor [n]
ROTTERS	ROTTER, a scoundrel [n]
ROTTING	ROT, to decompose [v]
ROTULAE	ROTULA, the knee-cap [n]
ROTULAS	ROTULA, the knee-cap [n]
ROTUNDA	a round building [n -S]
ROTUNDS	ROTUND, to round (to shape like a ball) [v]
ROULADE	a rolled up cake with a filling [n -S]
ROUNDEL	a round object, also ROUNDLE [n -S]
ROUNDER	a tool for rounding [n -S]
ROUNDLE	a round object, also ROUNDEL [n -S]
ROUSERS	ROUSER, one that rouses (to disturb or awaken) [n]
ROUSING	ROUSE, to disturb or awaken [v]
ROUSTER	a wharf labourer and deckhand [n -S]
ROUTERS	ROUTER, a scooping tool [n]
ROUTING	going to receptions [n -S]
RUDASES	RUDAS, a foul-mouthed old woman [n]
RUDERAL	a plant growing in poor land [n -S]
RUGOLAS	RUGOLA, a pungent salad herb [n]
RUGOSAS	RUGOSA, a garden rose [n]
RUINERS	RUINER, one who ruins (to destroy (to demolish, also DESTRUCT)) [n]
RUINING	the act of ruining [n -S]
RULERED	RULER, to strike with an implement for ruling lines [v]
RULESSE	unruly (difficult to control) [adj]
RULINGS	RULING, an authoritative decision [n]
RUNANGA	a Maori assembly or council [n -S]
RUNDALE	a system of holding land [n -S]
RUNDLES	RUNDLE, a rung (a crosspiece forming a step of a ladder) [n]
RUNDLET	a small barrel [n -S]
RUNLESS	scoring no runs in baseball [adj]
RUNNELS	RUNNEL, a small stream [n]
RUNNERS	RUNNER, one that runs (to move by rapid steps) [n]
RUNNIER	RUNNY, tending to drip [adj]
RUNRIGS	RUNRIG, a form of land-tenure [n]
RUSTIER	RUSTY, covered with rust [adj]
RUSTING	the act of rusting [n -S]
RUSTLED	RUSTLE, to steal cattle [v]
RUSTLER	one who rustles (to steal cattle) [n -S]
RUSTLES	RUSTLE, to steal cattle [v]
RUSTRED	having a rustre [adj]
RUSTRES	RUSTRE, a pierced lozenge (heraldry) [n]
RUTTERS	RUTTER, a mercenary cavalryman [n]
RUTTIER	RUTTY, marked by ruts [adj]
RUTTING	the act of rutting [n -S]
SAGENES	SAGENE, a fishing net [n]
SAGIEST	SAGY, flavoured with sage [adj]
SAGITTA	a keystone [n -S]
SAGOINS	SAGOIN, a South American monkey, also SAGOUIN, SAGUIN [n]
SAGOUIN	a South American monkey, also SAGOIN, SAGUIN [n -S]
SAGRADA	as in cascara sagrada, dried bark of the cascara buckthorn, used as a purgative [adj]
SAGUARO	a tall cactus, also SAHUARO [n -S]
SAGUINS	SAGUIN, a South American monkey, also SAGOIN, SAGOUIN [n]
SAILING	the act of one that sails (to be pushed in a boat by the wind) [n -S]
SAILORS	SAILOR, a member of a ship's crew [n]
SAINING	SAINE, to say (Spencer), also SAYNE [v]
SAIRING	SAIR, to wound (to inflict an injury upon) [v]
SALADES	SALADE, a light helmet [n]
SALINAS	SALINA, a pond, marsh or lake containing salt water [n]
SALOONS	SALOON, a tavern (an ale house) [n]
SALSAED	SALSA, to dance to rhythmic Latin-American music [v]
SALTANT	a mutated form of an organism suddenly developed [n -S]
SALTATE	to undergo an abrupt mutation [v SALTATED, SALTATING, SALTATES]
SALTATO	from pa p Italian to jump, skip, also SALTANDO [adv]
SALTEST	SALT, salty (tasting of salt) [adj]
SALTING	land regularly flooded by tides [n -S]
SALUING	SALUE, to salute (to greet with a sign of respect) [v]
SALUTED	SALUTE, to greet with a sign of respect [v]
SALUTES	SALUTE, to greet with a sign of respect [v]
SANDALS	SANDAL, to dress in light open shoes [v]
SANDING	the act of wearing down with a sander [n -S]
SANDLOT	a vacant lot [n -S]
SANGARS	SANGAR, a temporary fortification for two or three men, also SANGA [n]
SANGERS	SANGER, a sandwich, also SANGO [n]
SANGRIA	an alcoholic beverage [n -S]
SANIOUS	relating to sanies [adj]
SANNIES	SANNIE, a sandshoe (a lightweight sneaker) [n]
SANTALS	SANTAL, a sandalwood [n]
SANTOLS	SANTOL, a tropical tree [n]
SANTONS	SANTON, an Eastern saint [n]
SANTURS	SANTUR, a Persian stringed instrument, also SANTIR, SANTOOR, SANTOUR [n]
SAOUARI	an American tree [n -S]
SARANGI	an Indian stringed instrument [n -S]
SARDANA	a Spanish folk dance [n -S]
SARDARS	SARDAR, a person of rank in India, also SIRDAR [n]
SARDELS	SARDEL, a small fish, also SARDELLE [n]
SARDIUS	a variety of quartz, also SARD [n -ES]
SARONGS	SARONG, a draped cloth worn around the hips [n]
SARTORS	SARTOR, a tailor [n]
SATANGS	SATANG, a monetary unit of Thailand [n]
SATARAS	SATARA, a woollen fabric [n]
SATIATE	to satisfy to capacity, also SATE [v SATIATED, SATIATING, SATIATES]
SATORIS	SATORI, the illumination of spirit sought by Zen Buddhists [n]
SAUGERS	SAUGER, a freshwater fish [n]
SAULGES	SAULGE, a garden plant [n]
SAULIES	SAULIE, a hired mourner [n]
SAUNAED	SAUNA, to have a sauna [v]
SAURELS	SAUREL, a marine fish [n]
SAURIAN	any of a suborder of reptiles [n -S]
SAURIES	SAURY, a marine fish [n]
SAUROID	lizard-like [adj]
SAUSAGE	finely chopped and seasoned meat in a casing [n -S]
SAUTING	SAUT, to season (to improve flavour) [v]
SAUTOIR	a heraldic design, also SALTIRE, SALTIER, SAUTOIRE [n -S]
SDEIGNE	to disdain (to scorn (to treat with contempt)) [v SDEIGNED, SDEIGNING, SDEIGNES]
SDEIGNS	SDEIGN, to disdain (to scorn (to treat with contempt)) [v]
SEADOGS	SEADOG, a fogbow (a nebulous arc of light sometimes seen in fog, also FOGDOG) [n]
SEARATS	SEARAT, a pirate [n]
SEASIDE	the seashore (land bordering on the sea) [n -S]
SEASURE	a convulsion [n -S]
SEEDERS	SEEDER, one that seeds (to sow a crop) [n]
SEEDING	the act of seeding [n -S]
SEEINGS	SEEING, the act of one who sees (to observe with the eyes) [n]
SEELIER	SEELY, fortunate [adj]
SEELING	a ceiling (Spenser) [n -S]
SEGETAL	growing in fields of grain [adj]
SEIDELS	SEIDEL, a large beer glass [n]
SEILING	SEIL, to strain (to exert to the utmost) [v]
SEINING	the act of seining [n -S]
SEISING	the act of one that seizes, also SEIZING [n -S]
SEISURE	the act of seizing, also SEIZURE [n -S]
SEITIES	SEITY, personal identity [n]
SENDALS	SENDAL, a silk fabric [n]
SENDERS	SENDER, one who sends (to pitch into the trough of the sea (pa t SENDED), also SCEND, to make something or someone go to a place, pa t SENT) [n]
SENDING	dispatching [n -S]
SENEGAS	SENEGA, a medicinal plant root, also SENECA [n]
SENILES	SENILE, one who exhibits senility [n]
SENNETS	SENNET, a call on a trumpet for the entrance or exit of actors [n]
SENNITS	SENNIT, a braided straw used for making hats [n]
SENORES	SENOR, a Spanish gentleman [n]
SENSILE	responsive to stimulus [adj]
SENSING	the act of sensing [n -S]
SENSUAL	pertaining to the physical senses [adj]
SENTING	SENT, to scent (to fill with a perfume) [v]
SERANGS	SERANG, an Oriental boatswain [n]
SERENED	SERENE, to tranquillize [v]
SERENER	SERENE, calm, tranquil [adj]
SERENES	SERENE, to tranquillize [v]
SERGERS	SERGER, a machine for serging [n]
SERIOUS	thoughtful or subdued in appearance [adj]
SEROONS	SEROON, a crate, also SERON [n]
SERRANS	SERRAN, a fish [n]
SERRIES	SERRY, to crowd together [v]
SETOUTS	SETOUT, a display [n]
SETTEES	SETTEE, a long seat with a high back [n]
SETTERS	SETTER, to treat with a seton [v]
SETTING	the scenery used in a theatre production [n -S]
SETTLED	SETTLE, to place in a desired order [v]
SETTLER	one that settles (to place in a desired order) [n -S]
SETTLES	SETTLE, to place in a desired order [v]
SETUALE	a plant [n -S]
SETULES	SETULE, a small bristle [n]
SIALIDS	SIALID, an alderfly, also SIALIDAN [n]
SIALOID	resembling saliva (a fluid secreted by the glands of the mouth) [adj]
SIALONS	SIALON, ceramic material [n]
SIDINGS	SIDING, a short railway track for shunting [n]
SIDLERS	SIDLER, one who sidles (to move sideways) [n]
SIDLING	SIDLE, to move sideways [v]
SIEGERS	SIEGER, one who besieges, also BESIEGER [n]
SIENNAS	SIENNA, a brown pigment [n]
SIERRAS	SIERRA, a mountain range [n]
SIGANID	any of a family of fishes [n -S]
SIGNALS	SIGNAL, to notify by means of communication [v]
SIGNEES	SIGNEE, a signer of a document [n]
SIGNETS	SIGNET, to mark with an official seal [v]
SIGNIOR	an Italian title of courtesy for a man, also SIGNOR, SIGNORE [n -S]
SIGNORI	SIGNORE, an Italian title of courtesy for a man, also SIGNOR, SIGNIOR [n]
SIGNORS	SIGNOR, an Italian title of courtesy for a man, also SIGNIOR, SIGNORE [n]
SILAGES	SILAGE, to harvest and store a crop [v]
SILENES	SILENE, a flowering plant [n]
SILENUS	a woodland deity of Greek mythology [n SILENI]
SILESIA	a cotton fabric [n -S]
SILOING	SILO, to store in a large cylindrical structure [v]
SILTING	SILT, to fill with a fine sediment [v]
SILURID	any of a family of catfishes, also SILUROID [n -S]
SINDING	SIND, to rinse (to cleanse with clear water) [v]
SINDONS	SINDON, fine cloth [n]
SINGLED	SINGLE, to select from a group [v]
SINGLES	SINGLE, to select from a group [v]
SINGULT	a sob [n -S]
SINNERS	SINNER, to transgress, to act as a sinner [v]
SINNETS	SINNET, a flat braid [n]
SINUOSE	characterized by curves, bends or turns, also SINUOUS [adj]
SIRDARS	SIRDAR, a person of rank in India, also SARDAR [n]
SIRINGS	SIRING, the act of begetting (to produce (to bring into existence)) [n]
SIRLOIN	a cut of beef [n -S]
SIRREES	SIRREE, sir, also SIREE [n]
SIRRING	SIR, to use a respectful form of address to a man [v]
SIRTUIN	any of a group of enzymes which regulate cell metabolism and aging [n -S]
SISTING	SIST, to stop (to halt or discontinue) [v]
SITTARS	SITTAR, an Indian lute, also SITAR [n]
SITTERS	SITTER, one who sits (to rest on the buttocks) [n]
SITTING	a meeting or session [n -S]
SITUATE	to place in a certain position [v SITUATED, SITUATING, SITUATES]
SLADANG	a wild ox, also SALADANG, SELADANG [n -S]
SLAIRGS	SLAIRG, to smear (to spread with something oily or sticky) [v]
SLANGED	SLANG, to use extremely informal language [v]
SLATING	the act of covering with slate [n -S]
SLATTED	SLAT, to supply with narrow strips of wood or metal [v]
SLEDGER	one who drives a sledge [n -S]
SLEDGES	SLEDGE, to convey on a type of sled [v]
SLEETED	SLEET, to shower frozen rain [v]
SLENDER	slim (slender) [adj SLENDERER, SLENDEREST]
SLIDERS	SLIDER, one that slides (to move smoothly along a surface) [n]
SLIDING	the act of sliding [n -S]
SLITTED	SLIT, to make a long narrow cut in [v]
SLOGANS	SLOGAN, a motto adopted by a group [n]
SLOTTED	SLOT, to cut a long narrow opening in [v]
SLUDGES	SLUDGE, to cover with a muddy deposit [v]
SLUEING	SLUE, to cause to move sideways, also SLEW [v]
SLURRED	SLUR, to disparage [v]
SNARERS	SNARER, one that snares (to trap (to catch in a snare)) [n]
SNARING	the act of snaring [n -S]
SNEEING	SNEE, to cut (to sever (to divide or cut into parts)) [v]
SNEERED	SNEER, to curl the lip in contempt [v]
SNEERER	one who sneers (to curl the lip in contempt) [n -S]
SNIDING	SNIDE, to fill or load [v]
SNOOLED	SNOOL, to yield meekly [v]
SNOOTED	SNOOT, to treat with disdain [v]
SNORERS	SNORER, one that snores (to breath noisily while sleeping) [n]
SNORING	the act of snoring [n -S]
SNOTTED	SNOT, to blow the nose [v]
SNOUTED	SNOUT, to provide with a nozzle [v]
SNUDGES	SNUDGE, to be snug and quiet [v]
SOARERS	SOARER, one that soars (to fly at a great height) [n]
SODGERS	SODGER, a soldier [n]
SOILING	the act of soiling [n -S]
SOIREES	SOIREE, an evening party [n]
SOLANDS	SOLAND, a large sea bird (the gannet), also SOLAN [n]
SOLANIN	a poisonous alkaloid, also SOLANINE [n -S]
SOLANOS	SOLANO, a strong, hot wind [n]
SOLARIA	SOLARIUM, a room exposed to the sun [n]
SOLDANS	SOLDAN, a Muslim ruler, also SOUDAN, SULDAN [n]
SOLDERS	SOLDER, to join together with heat [v]
SOLIDUS	a coin of ancient Rome [n SOLIDI]
SOLIONS	SOLION, an electronic detecting and amplifying device [n]
SOLITON	a solitary wave in physics [n -S]
SOLOING	SOLO, to perform alone [v]
SOLOIST	one who performs alone [n -S]
SOLUNAR	pertaining to tables of solar and lunar times [adj]
SOLUTES	SOLUTE, a dissolved substance [n]
SONANTS	SONANT, a sound made by vibration of the vocal chords [n]
SONATAS	SONATA, a type of musical composition [n]
SONDAGE	a trial bore [n -S]
SONNETS	SONNET, to compose a type of poem [v]
SONNIES	SONNY, a small boy [n]
SONTAGS	SONTAG, a woman's knitted cape [n]
SOOGEED	SOOGEE, to clean ships with a special cleaning agent, also SOOGIE [v]
SOOGEES	SOOGEE, to clean ships with a special cleaning agent, also SOOGIE [v]
SOOGIED	SOOGIE, to clean ships with a special cleaning agent, also SOOGEE [v]
SOOGIES	SOOGIE, to clean ships with a special cleaning agent, also SOOGEE [v]
SOOLING	SOOL, to incite to attack [v]
SOONERS	SOONER, one who settles on government prematurely [n]
SOONEST	SOON, in the near future [adv]
SOOTING	SOOT, to cover with a residue of burning [v]
SORAGES	SORAGE, a hawk in its first year [n]
SORDINI	SORDINO, a device used to muffle the tone of a musical instrument [n]
SORDINO	a device used to muffle the tone of a musical instrument [n SORDINI]
SORDORS	SORDOR, a sordid state [n]
SORINGS	SORING, the training of a horse to high step [n]
SORNERS	SORNER, one who sorns (to "free-load" for food and lodging) [n]
SORNING	the act of sorning [n -S]
SORORAL	sisterly (resembling a sister) [adj]
SORRELS	SORREL, a reddish-brown colour, also SOREL, SORELL [n]
SORTALS	SORTAL, in linguistics, a word which requires individual characteristics [n]
SORTERS	SORTER, one that sorts (to arrange in class, kind or size) [n]
SOTTING	the act of sotting [n -S]
SOUARIS	SOUARI, a tropical tree [n]
SOUDANS	SOUDAN, a Muslim ruler, also SOLDAN, SULDAN [n]
SOULDAN	a sultan (the ruler of a Muslim country) [n -S]
SOUREST	SOUR, sharp or biting to the taste [adj]
SOURING	the process of becoming sour [n -S]
SOUSING	the act of sousing [n -S]
SOUTARS	SOUTAR, a shoemaker, also SOUTER [n]
SOUTERS	SOUTER, a shoemaker, also SOUTAR [n]
SOUTIES	SOUTIE, an English speaking South African., also SOUTPIEL [n]
STADIAL	a substance which depends on the life of a glacier [n -S]
STADIAS	STADIA, a method of surveying distances [n]
STALAGS	STALAG, a German prisoner-of-war camp [n]
STALEST	STALE, not fresh [adj]
STALING	STALE, to become past its best [v]
STANING	STANE, to stone (to pelt with pieces or mineral matter) [v]
STANOLS	STANOL, a fully saturated phytosterol [n]
STARERS	STARER, one who stares (to gaze fixedly) [n]
STARETS	a spiritual adviser in the Eastern Orthodox Church, also STARETZ [n STARETSES or STARTSY]
STARLIT	lit by stars [adj]
STARTER	one who starts (to begin (to start)) [n -S]
STATERS	STATER, one who states (to affirm (to state positively)) [n]
STATING	STATE, to affirm (to state positively) [v]
STATINS	STATIN, any of a class of drugs that reduce serum cholesterol levels [n]
STATORS	STATOR, a part of a machine about which the rotor revolves [n]
STATUAS	STATUA, representation of a round human or animal form [n]
STATUED	having a statue [adj]
STATUES	STATUE, a three-dimensional work or art [n]
STATURE	the natural height of a human or animal body [n -S]
STEALES	STEALE, a handle [n]
STEELED	STEEL, to cover with a tough iron alloy [v]
STEENED	STEEN, to line with stone [v]
STEERED	STEER, to guide or direct [v]
STEERER	one who steers (to guide or direct) [n -S]
STELENE	pertaining to a stela (an inscribed slab used as a monument) [adj]
STENNED	STEN, to bound (to leap (to spring off the ground)) [v]
STENTED	STENT, to stint (to limit (to restrict (to keep within boundaries))) [v]
STERLET	a small sturgeon (an edible fish) [n -S]
STERTOR	a deep snoring sound [n -S]
STETSON	a broad-brimmed high-crowned felt hat [n -S]
STILETS	STILET, a probe [n]
STILING	STILE, to designate [v]
STILTED	STILT, to raise on long slender poles [v]
STINGOS	STINGO, a strong ale or beer [n]
STIRING	STIRE, to set in motion [v]
STIRRAS	STIRRA, sir [n]
STIRRES	STIRRE, to bolt (to run away) [v]
STODGES	STODGE, to stuff full of food [v]
STOGIES	STOGIE, a long, slender cigar, also STOGY, STOGEY [n]
STOLONS	STOLON, a type of plant stem [n]
STONING	the act of stoning [n -S]
STONNED	STONNE, to stun, also STONN [v]
STONNES	STONNE, to stun, also STONN [v]
STOODEN	STAND, to assume an upright position [v]
STOOGED	STOOGE, to act as a comedian's straight man [v]
STOOGES	STOOGE, to act as a comedian's straight man [v]
STOOLED	STOOL, to defecate (to discharge faeces) [v]
STORERS	STORER, one who stores things [n]
STORGES	STORGE, natural affection [n]
STOTINS	STOTIN, a monetary unit of Slovenia [n]
STOUNDS	STOUND, to ache (to endure a dull lasting pain, also AKE) [v]
STOURES	STOURE, dust, also STOUR [n]
STOUTEN	to make stout (robust (strong and healthy)) [v -ED, -ING, -S]
STOUTER	STOUT, robust (strong and healthy) [adj]
STRAITS	STRAIT, to tighten (to make taut (fully stretched)) [v]
STRANDS	STRAND, to leave in an unfavourable situation [v]
STRATAL	pertaining to a stratum, also STRATOUS [adj]
STRATAS	STRATA, stratum (a layer of material) [n]
STRATUS	a type of cloud [n STRATI]
STREELS	STREEL, to saunter (to walk in a leisurely manner) [v]
STREETS	STREET, a public thoroughfare [n]
STRIATA	STRIATUM, part of the forebrain [n]
STRIDOR	a strident sound [n -S]
STRIGIL	a scraping instrument [n -S]
STRINGS	STRING, to provide with catgut, silk, wire or cord [v]
STRONDS	STROND, a thread [n]
STROUDS	STROUD, a coarse woollen blanket [n]
STROUTS	STROUT, to bulge (to swell out) [v]
STRUDEL	a pastry with fruit [n -S]
STRUNTS	STRUNT, to walk with a pompous air, also STRUT [v]
STUDENT	a person formally engaged in learning [n -S]
STUDIES	STUDY, to apply oneself to learning [v]
STUDIOS	STUDIO, an artist's workroom [n]
STUNNED	STUN, to render unconscious [v]
STUNTED	STUNT, to hinder from growth [v]
STURTED	STURT, to annoy (to irritate (to provoke (to arouse to anger or sexual desire))) [v]
SUASION	persuasion [n -S]
SUDARIA	SUDARIUM, a cloth for wiping the face, also SUDARY [n]
SUDATES	SUDATE, to sweat (to perspire (to exude sweat through the pores of the skin)) [v]
SUDORAL	pertaining to sweat [adj]
SUDSIER	SUDSY, foamy (covered with foam) [adj]
SUDSING	SUDS, to wash in soapy water [v]
SUEDING	SUEDE, to finish leather with a soft, napped surface [v]
SUGARED	SUGAR, to sweeten with a carbohydrate [v]
SUGARER	one that makes sugar [n -S]
SUIDIAN	a member of the pig family [n -S]
SUITERS	SUITER, a special suitcase for holding suits [n]
SUITING	fabric for making suits [n -S]
SUITORS	SUITOR, to court a woman [v]
SULDANS	SULDAN, a Muslim ruler, also SOLDAN, SOUDAN [n]
SULTANA	a sultan's wife [n -S]
SULTANS	SULTAN, the ruler of a Muslim country [n]
SUNDAES	SUNDAE, a dish of icecream served with topping [n]
SUNDARI	a timber tree, also SUNDRA, SUNDRI [n -S]
SUNDERS	SUNDER, to break apart [v]
SUNDIAL	a type of time-telling device [n -S]
SUNDOGS	SUNDOG, a small rainbow (an arc of spectral colours formed in the sky) [n]
SUNDRAS	SUNDRA, a timber tree, also SUNDARI, SUNDRI [n]
SUNDRIS	SUNDRI, a timber tree, also SUNDARI, SUNDRA [n]
SUNGARS	SUNGAR, a look-out post [n]
SUNLAND	an area marked by a great amount of sunshine [n -S]
SUNNIER	SUNNY, filled with sunlight [adj]
SUNNIES	(Australia) sunglasses [n]
SUNRISE	the ascent of the sun above the horizon in the morning [n -S]
SUNSTAR	a type of starfish (a star-shaped marine animal) [n -S]
SUNTANS	SUNTAN, a brown skin colour as a result of sun exposure\v to tan in the sun [n]
SURGEON	one who practices surgery (the treatment of medical problems by operation) [n -S]
SURGERS	SURGER, one that surges (to move in a swelling manner) [n]
SURGIER	SURGY, surging [adj]
SURLIER	SURLY, sullenly rude [adj]
SURLOIN	the upper part of a loin of beef [n -S]
SURREAL	the atmosphere or qualities associated with surrealism [n -S]
SUSTAIN	to maintain by providing with food and drink [v -ED, -ING, -S]
SUTLERS	SUTLER, one who peddles goods to soldiers [n]
SUTTEES	SUTTEE, the cremation of a Hindu woman on her husband's pile, also SATI [n]
SUTTLED	SUTTLE, to trade as a camp hawker [v]
SUTTLES	SUTTLE, to trade as a camp hawker [v]
TAGETES	a plant [n TAGETES]
TAGLESS	without a tag [adj]
TAGUANS	TAGUAN, a squirrel [n]
TAIGLED	TAIGLE, to entangle (to twist together) [v]
TAILARD	a person with a tail [n -S]
TAILING	the refuse part of mined ore [n -S]
TALANTS	TALANT, a talon, also TALAUNT [n]
TALARIA	winged sandals or ankles in Greek mythology [n]
TALAUNT	a talon, also TALANT [n -S]
TALONED	having a talon [adj]
TALUSES	TALUS, a slope formed by an accumulation of rock debris [n]
TANADAR	an officer in charge of a tana [n -S]
TANAGRA	a terracotta figurine [n -S]
TANDOOR	a clay oven [n TANDOORS or TANDOORI]
TANGELO	a citrus fruit [n -S]
TANGENT	a line that touches a curve [n -S]
TANGLED	TANGLE, to form into an interwoven mass [v]
TANGOED	TANGO, to perform a Latin-American dance [v]
TANGUNS	TANGUN, a pony [n]
TANISTS	TANIST, the heir apparent to a Celtic chief [n]
TANLING	a person tanned by the sun [n -S]
TANNAGE	the process of tanning [n -S]
TANNATE	a chemical salt [n -S]
TANNEST	TAN, tawny brown [adj]
TANTARA	the sound of a trumpet or horn [n -S]
TANTRAS	TANTRA, a class of Hindu religious writings [n]
TAONGAS	TAONGA, (Maori) something highly prized [n]
TARAIRE	a type of New Zealand tree with broad green leaves and purple fruit [n -S]
TARANDS	TARAND, a reindeer (a large deer (a ruminant mammal)) [n]
TARRING	the act of tarring [n -S]
TARSALS	TARSAL, a bone of the foot [n]
TARSIAS	TARSIA, a decorative wood inlay [n]
TARTANA	a mediterranean sailing vessel, also TARTANE [n -S]
TARTANE	a mediterranean sailing vessel, also TARTANA [n -S]
TARTANS	TARTAN, a patterned woollen fabric [n]
TARTARE	a tasty sauce [n -S]
TARTARS	TARTAR, a crust on the teeth [n]
TARTING	TART, to dress up [v]
TASLETS	TASLET, a piece of armour in a skirt [n]
TASTERS	TASTER, one who tastes (to savour with the tongue) [n]
TASTING	the act of tasting [n -S]
TATSOIS	TATSOI, an Asian mustard [n]
TATUING	TATU, to mark the skin, also TATTOW [v]
TAUNTED	TAUNT, to goad or provoke [v]
TAUNTER	one who taunts (to goad or provoke) [n -S]
TAUREAN	relating to a bull [adj]
TAUTENS	TAUTEN, to make taut (fully stretched) [v]
TAUTING	TAUT, to tangle (to form into an interwoven mass) [v]
TAUTOGS	TAUTOG, a marine fish, also TAUTAUG [n]
TEAGLED	TEAGLE, to hoist (to raise with tackle) [v]
TEAGLES	TEAGLE, to hoist (to raise with tackle) [v]
TEASELS	TEASEL, to raise a nap on fabric, also TEAZEL, TEAZLE [v]
TEDIEST	TEDY, tedious (causing weariness) [adj]
TEENAGE	the age between 13 and 20 [n -S]
TEENING	TEENE, to allot (to share out) [v]
TEETERS	TEETER, to move unsteadily [v]
TEGULAE	TEGULA, a scale on the wings of insects [n]
TEGULAR	resembling a tile [adj]
TELEDUS	TELEDU, a carnivorous mammal [n]
TELEGAS	TELEGA, a Russian wagon [n]
TELEOST	a bony fish [n -S]
TELESES	TELESIS, planned progress [n]
TELNETS	TELNET, to access a computer system remotely [v]
TELSONS	TELSON, the terminal segment of an arthropod [n]
TENANTS	TENANT, to inhabit (to live in) [v]
TENDING	TEND, to watch over [v]
TENDONS	TENDON, a cord or fibrous tissue [n]
TENDRIL	a coiling, threadlike, climbing organ of a plant [n -S]
TENDRON	a shoot [n -S]
TENIOID	like a tapeworm [adj]
TENNIST	a tennis player [n -S]
TENONED	TENON, to affix with a projection at the end of a piece of wood [v]
TENONER	one that tenons (to affix with a projection at the end of a piece of wood) [n -S]
TENSEST	TENSE, taut (fully stretched) [adj]
TENSING	TENSE, to make taut (fully stretched) [v]
TENSONS	TENSON, a competition in verse, also TENZON [n]
TENTAGE	a supply of tents [n -S]
TENTIGO	morbid lasciviousness [n -S]
TENTING	the act of tenting [n -S]
TENURED	TENURE, to grant tenure to [v]
TENUTOS	TENUTO, a sustained note or chord [n]
TERETES	TERES, a muscle of the shoulder blade [n]
TERGITE	the back of an arthropod, also TERGUM [n -S]
TERNING	TERNE, to cover with an alloy of lead and tin [v]
TERREEN	an earthenware jar, also TERRINE [n -S]
TERRENE	a land area [n -S]
TERRETS	TERRET, a metal ring on a harness, also TERRIT [n]
TERRITS	TERRIT, a metal ring on a harness, also TERRET [n]
TERSEST	TERSE, succinct (clearly expressed in a few words) [adj]
TERTIUS	the third person [n -ES]
TESTEES	TESTEE, one who is tested [n]
TESTERS	TESTER, one who tests (to examine critically) [n]
TESTING	the act of testing [n -S]
TESTONS	TESTON, a former French coin, also TESTOON [n]
TESTOON	a former French coin, also TESTON [n -S]
TESTUDO	a portable shield used by the ancient Romans [n -S]
TETANAL	pertaining to tetanus (a disease due to bacillus) [adj]
TETANUS	a disease due to bacillus [n -ES]
TETRODE	a type of electron tube [n -S]
TIDIEST	TIDY, neat and orderly [adj]
TIDINGS	TIDING, a piece of news [n]
TIGLONS	TIGLON, the offspring of a male tiger and a female lion, also TIGON [n]
TIGRESS	a female tiger (a fierce, striped Asiatic animal) [n -ES]
TIGROID	like a tiger [adj]
TILINGS	TILING, a surface of tiles [n]
TILTING	the act of leaning [n -S]
TINDALS	TINDAL, a petty officer [n]
TINDING	TIND, to kindle (to cause to burn) [v]
TINGLED	TINGLE, to cause a prickly, stinging sensation [v]
TINGLER	one that tingles (to cause a prickly, stinging sensation) [n -S]
TINTING	the process of one that tints [n -S]
TIREDER	TIRED, exhausted [adj]
TIRINGS	TIRING, the act of tiring [n]
TIRITIS	TIRITI, Maori word for treaty, especially the treaty of Waitangi [n]
TIRLING	TIRL, to make a vibrating sound [v]
TIRRING	TIRR, to strip (to remove the outer covering) [v]
TIRRITS	TIRRIT, alarm or fright [n]
TISSUAL	pertaining to tissue [adj]
TISSUED	TISSUE, to weave into a fine, sheer fabric [v]
TITANIA	a mineral [n -S]
TITANIS	a prehistoric bird [n -ES]
TITIANS	TITIAN, a reddish-brown colour [n]
TITLING	the giving of a title [n -S]
TITULAR	one who holds a title, also TITULARY [n -S]
TITULED	TITULE, to give a title to [v]
TITULES	TITULE, to give a title to [v]
TOEIEST	TOEY, nervous (easily excited) [adj]
TOELESS	having no toes [adj]
TOETOES	TOETOE, New Zealand grass, also TOITOI [n]
TOGATED	wearing a toga [adj]
TOILING	the act of toiling [n -S]
TOISONS	TOISON, a fleece [n]
TOITING	TOIT, to saunter (to walk in a leisurely manner) [v]
TOITOIS	TOITOI, New Zealand grass, also TOETOE [n]
TOLEDOS	TOLEDO, a finely tempered sword [n]
TOLIDIN	a chemical compound, also TOLIDINE [n -S]
TOLINGS	TOLING, the use of toll-bait, also TOLLING [n]
TOLUATE	a chemical salt [n -S]
TOLUENE	a solvent derived from coal tar, also TOLUOL, TOLUOLE [n -S]
TOLUIDE	a derivative of glycocoll, also TOLUID, TOLUIDIN [n -S]
TOLUIDS	TOLUID, a derivative of glycocoll, also TOLUIDE, TOLUIDIN [n]
TONDINI	TONDINO, a circular moulding [n]
TONDINO	a circular moulding [n TONDINOS or TONDINI]
TONGUED	TONGUE, to touch with the fleshy organ of the mouth [v]
TONGUES	TONGUE, to touch with the fleshy organ of the mouth [v]
TONINGS	TONING, a quality or character of sound [n]
TONLETS	TONLET, a skirt of plate armour [n]
TONNAGE	total weight in tons, also TUNNAGE [n -S]
TONNAGS	TONNAG, a shawl [n]
TONNEAU	the rear seating compartment of an automobile [n TONNEAUS or TONNEAUX]
TONSILS	TONSIL, a lymphoid organ [n]
TONSORS	TONSOR, a barber [n]
TONTINE	a form of collective life insurance [n -S]
TONUSES	TONUS, the normal state of tension in muscle tissue [n]
TOOARTS	TOOART, an Eucalyptus tree [n]
TOOLING	ornamentation done with tools [n -S]
TOOLSET	a group of related tools in a computer application [n -S]
TOOTERS	TOOTER, one that toots (to say tut) [n]
TOOTING	TOOT, to sound a horn [v]
TOOTLED	TOOTLE, to toot softly and repeatedly [v]
TOOTLER	one who tootles (to toot softly and repeatedly) [n -S]
TOOTLES	TOOTLE, to toot softly and repeatedly [v]
TOOTSED	TOOTS, to say tut [v]
TOOTSES	TOOTS, to say tut [v]
TOOTSIE	a foot, also TOOTSY [n -S]
TORDION	an old dance [n -S]
TOREROS	TORERO, a bullfighter, also TOREADOR [n]
TORNADE	a thunderstorm [n -S]
TORNADO	a violent windstorm [n TORNADOS or TORNADOES]
TOROIDS	TOROID, a type of geometric surface [n]
TORRENT	a rapid stream of water [n -S]
TORRETS	TORRET, a swivel-ring [n]
TORTILE	twisted [adj]
TORTONI	a type of ice cream [n -S]
TORTURE	to subject to severe physical pain [v TORTURED, TORTURING, TORTURES]
TORULAE	TORULA, a type of fungus (any of the major group of lower plants) [n]
TORULAS	TORULA, a type of fungus (any of the major group of lower plants) [n]
TORULIN	a vitamin in yeast [n -S]
TOSSING	the act of tossing [n -S]
TOSTADA	a tortilla fried in fat, also TOSTADO [n -S]
TOSTADO	a tortilla fried in fat, also TOSTADA [n -S]
TOTALED	TOTAL, to amount to [v]
TOTANUS	a bird [n -ES]
TOTARAS	TOTARA, a New Zealand tree [n]
TOURERS	TOURER, a large, open automobile [n]
TOURING	cross-country skiing for pleasure [n -S]
TOURIST	one who tours for pleasure [n -S]
TOUSERS	TOUSER, one who touses (to dishevel, also TOUSLE, TOUZLE) [n]
TOUSING	the act of tousing [n -S]
TOUSLED	TOUSLE, to dishevel, also TOUSE, TOUZLE [v]
TOUSLES	TOUSLE, to dishevel, also TOUSE, TOUZLE [v]
TOUSTIE	irascible [adj TOUSTIER, TOUSTIEST]
TOUTERS	TOUTER, one who touts (to solicit brazenly) [n]
TOUTIER	TOUTIE, petulant (peevish (irritable)) [adj]
TOUTING	TOUT, to solicit brazenly [v]
TRADING	the act of trading [n -S]
TRAGULE	a mouse deer [n -S]
TRAITOR	one who betrays another [n -S]
TRANTED	TRANT, to hawk (to peddle (to sell or offer for sale)) [v]
TRANTER	a hawker (a peddler (one who peddles, also PEDLAR, PEDLER)) [n -S]
TREADER	one who treads (to walk on, over, or along) [n -S]
TREADLE	to work by a foot pedal, also TREDDLE [v TREADLED, TREADLING, TREADLES]
TREAGUE	a truce [n -S]
TREATED	TREAT, to deal with [v]
TREATER	one who treats (to deal with) [n -S]
TRENTAL	a series of thirty requiem masses [n -S]
TRESSED	TRESS, to form into long locks of hair [v]
TRESSEL	a framework for supporting a bridge, also TRESTLE [n -S]
TRESTLE	a framework for supporting a bridge, also TRESSEL [n -S]
TRIDARN	a Welsh dresser [n -S]
TRIDENT	a spear with three prongs [n -S]
TRIDUAN	lasting three days [adj]
TRIGLOT	a book written in three languages [n -S]
TRINDLE	to propel by causing to rotate, also TRUNDLE [v TRINDLED, TRINDLING, TRINDLES]
TRINGLE	a curtain-rod [n -S]
TRINING	TRINE, to place in a particular astrological position [v]
TRIOLET	a short poem of fixed form [n -S]
TRISULA	a trident of Siva, also TRISUL [n -S]
TRISULS	TRISUL, a trident of Siva, also TRISULA [n]
TRITIDE	a compound of tritium [n -S]
TROATED	TROAT, to bellow (to roar like a bull) [v]
TROELIE	a leaf of the bussu palm, also TROELY, TROOLIE [n -S]
TROGONS	TROGON, a tropical bird [n]
TROILUS	a large butterfly [n -ES]
TROLAND	a unit of measurement of retinal response to light [n -S]
TROOLIE	a leaf of the bussu palm, also TROELIE, TROELY [n -S]
TROULED	TROULE, to trundle (to propel by causing to rotate, also TRINDLE) [v]
TROUSER	to appropriate or pocket money [v -ED, -ING, -S]
TROUSES	TROUSE, trews (that which is true) [n]
TROUTER	a trout fisherman [n -S]
TRUANTS	TRUANT, an absentee from school [n]
TRUDGEN	a swimming stroke, also TRUDGEON [n -S]
TRUDGER	one who trudges (to walk tiredly) [n -S]
TRUDGES	TRUDGE, to walk tiredly [v]
TRUNDLE	to propel by causing to rotate, also TRINDLE [v TRUNDLED, TRUNDLING, TRUNDLES]
TRUNNEL	a wooden peg used to fasten timber, also TREENAIL, TRENAIL [n -S]
TRUSSED	TRUSS, to secure tightly [v]
TRUSSER	one that trusses (to secure tightly) [n -S]
TRUSTED	TRUST, to place confidence in [v]
TRUSTEE	to entrust to an administrator [v TRUSTEED, TRUSTEEING, TRUSTEES]
TRUSTER	one who trusts (to place confidence in) [n -S]
TRUSTOR	one who trustees his property [n -S]
TSANTSA	(Ecuador) the shrunken head of an enemy kept as a trophy [n -S]
TSARIST	a supporter of tsarism, also CZARIST, TZARIST [n -S]
TSOORIS	a series of misfortunes, also TSORIS, TSORES, TSORRISS, TSURIS, TZURIS [n TSOORIS]
TSOURIS	grief (intense mental stress) [n -ES]
TUATARA	a large reptile, also TUATERA [n -S]
TUATERA	a large reptile, also TUATARA [n -S]
TUGLESS	being without a rope or chain to pull [adj]
TUITION	a fee for instruction [n -S]
TULADIS	TULADI, a freshwater fish [n]
TUNDING	TUND, to beat (to strike repeatedly) [v]
TUNDRAS	TUNDRA, a level, treeless expanse of arctic land [n]
TUNIEST	TUNY, tuneful (melodious) [adj]
TUNINGS	TUNING, the act of tuning [n]
TUNNAGE	total weight in tons, also TONNAGE [n -S]
TUNNELS	TUNNEL, an underground passageway [n]
TUNNIES	TUNNY, a tuna fish [n]
TURDION	a dance [n -S]
TURGENT	swollen [adj]
TURGITE	an iron ore [n -S]
TURGORS	TURGOR, the state of being turgid, also TURGENCY [n]
TURISTA	travellers' intestinal sickness, also TOURISTA [n -S]
TURNING	a rotation about an axis [n -S]
TURNONS	TURNON, something that arouses interest [n]
TURRETS	TURRET, a small tower [n]
TURTLED	TURTLE, to hunt a marine reptile [v]
TURTLER	one that turtles (to hunt a marine reptile) [n -S]
TURTLES	TURTLE, to hunt a marine reptile [v]
TUSSLED	TUSSLE, to struggle (to strive vigorously in resistance) [v]
TUSSORE	an Asian silkworm, also TUSSAR, TUSSEH, TUSSER, TUSSOR, TUSSUR [n -S]
TUTANIA	a type of Britannia metal [n -S]
TUTELAR	one who has the power to protect, also TUTELARY [n -S]
TUTENAG	an alloy [n -S]
TUTORED	TUTOR, to instruct privately [v]
TUTRESS	a female tutor [n -ES]
TUTSANS	TUTSAN, park leaves [n]
TUTSING	TUTS, to say tut [v]
UGLIEST	UGLY, offensive to sight [adj]
ULNARIA	ULNARE, the bone of the carpus [n]
ULSTERS	ULSTER, a long, loose overcoat [n]
ULTIONS	ULTION, revenge [n]
UNAGILE	not agile [adj]
UNALIST	a holder of one benefice [n -S]
UNDEALT	not dealt [adj]
UNDERGO	to be subjected to [v UNDERWENT, UNDERGONE, UNDERGOING, UNDERGOES]
UNDERNS	UNDERN, the third hour [n]
UNDINES	UNDINE, a female water spirit, also ONDINE [n]
UNDOING	the reversal of what has been done [n -S]
UNDRESS	to take off clothing [v UNDRESSED, UNDREST or UNDRESSED, UNDRESSING, UNDRESSES]
UNEAGER	not eager [adj]
UNEARED	not eared [adj]
UNEASES	UNEASE, mental or physical discomfort [n]
UNEATEN	not eaten [adj]
UNEDGES	UNEDGE, to blunt (to make dull (mentally slow)) [v]
UNGATED	not gated [adj]
UNGEARS	UNGEAR, to unharness [v]
UNGILDS	UNGILD, to remove the gild from [v]
UNGIRDS	UNGIRD, to remove a belt from [v]
UNGORED	unwounded, also UNGORD [adj]
UNGREEN	not green [adj]
UNIDEAL	not ideal [adj]
UNISONS	UNISON, complete agreement [n]
UNITAGE	amount in units [n -S]
UNITARD	a leotard that also covers the legs [n -S]
UNITING	the state of uniting [n -S]
UNITION	conjunction [n -S]
UNLADEN	UNLADE, to unload (to remove cargo from) [v]
UNLADES	UNLADE, to unload (to remove cargo from) [v]
UNLEADS	UNLEAD, to remove the lead from [v]
UNLEARN	to put out of one's memory [v UNLEARNED, UNLEARNT, UNLEARNING, UNLEARNS]
UNLINED	UNLINE, to remove the lining [v]
UNLINES	UNLINE, to remove the lining [v]
UNLOADS	UNLOAD, to remove cargo from [v]
UNLOOSE	to set free, also UNLOOSEN [v UNLOOSED, UNLOOSING, UNLOOSES]
UNLORDS	UNLORD, to strip of the dignity of a lord [v]
UNNAILS	UNNAIL, to remove the nails from [v]
UNNESTS	UNNEST, to turn out of a nest [v]
UNNOTED	not noted [adj]
UNOILED	not oiled [adj]
UNORDER	to countermand [v -ED, -ING, -S]
UNRATED	not rated [adj]
UNREELS	UNREEL, to unwind from a reel [v]
UNREINS	UNREIN, to give rein to [v]
UNRISEN	not risen [adj]
UNROOST	to drive from a roost [v -ED, -ING, -S]
UNROOTS	UNROOT, to uproot (to pull up by the roots) [v]
UNSAINT	to divest of saintliness [v -ED, -ING, -S]
UNSEALS	UNSEAL, to break the seal of [v]
UNSEATS	UNSEAT, to remove from a seat [v]
UNSEELS	UNSEEL, to undo the seeling of [v]
UNSEENS	UNSEEN, an unprepared passage for translation [n]
UNSENSE	to deprive of sense [v UNSENSED, UNSENSING, UNSENSES]
UNSLAIN	not slain [adj]
UNSLING	to remove from a slung position [v UNSLUNG, UNSLINGING, UNSLINGS]
UNSNAGS	UNSNAG, to free of snags [v]
UNSNARL	to untangle (to free from tangles) [v -ED, -ING, -S]
UNSOLID	not solid [adj]
UNSOOTE	unsweet (not sweet) [adj]
UNSTAID	not staid [adj]
UNSTATE	to deprive of status [v UNSTATED, UNSTATING, UNSTATES]
UNSTEEL	to make soft (yielding easily to pressure) [v -ED, -ING, -S]
UNTENTS	UNTENT, to remove from a tent [v]
UNTILED	UNTILE, to strip of tiles [v]
UNTONED	not toned [adj]
UNTREAD	to retrace (to go back over) [v UNTROD or UNTREADED, UNTRODDEN, UNTREADING, UNTREADS]
URANIAN	heavenly (full of beauty and peace) [adj]
URANIAS	URANIA, uranium dioxide [n]
URANINS	URANIN, a sodium (a metallic element) [n]
UREASES	UREASE, an enzyme that converts urea to a salt, also URASE [n]
UREDINE	pertaining to uredo (rust in plants) [adj]
URETERS	URETER, a duct that conveys urine from the kidney to the bladder [n]
URIDINE	a chemical compound [n -S]
URINALS	URINAL, a fixture used for urinating [n]
URINANT	diving head downward [adj]
URINING	URINE, to discharge a liquid containing body wastes [v]
URNINGS	URNING, a male homosexual [n]
URODELE	a type of amphibian [n -S]
USAGERS	USAGER, someone who has the use of anything in trust for another [n]
USTIONS	USTION, a burning (the firing of ceramic materials) [n]
UTILISE	to make use of, also UTILIZE [v UTILISED, UTILISING, UTILISES]
UTTERED	UTTER, to give voice to [v]
UTTERER	one who utters more UTTER [n -S]
